ID,Location,Specific Location,Amenities,Bedroom,Bathroom,Toilet,New,Duplex,Lux,Estate,rank,Price
0,ajah,"6, abimbola owodunni close, seaside estate, off badore road, ajah, lekki, lagos. badore ajah lagos",7,4,3,4,0,0,0,1,5,1200000
1,ajah,badore ajah lagos,9,5,4,5,1,1,0,1,8,3000000
2,ajah,lekki palm city ajah lagos,11,6,5,6,1,1,0,1,9,4000000
3,ajah,- thomas estate ajah lagos,9,5,4,5,1,1,1,1,8,5000000
4,ajah,ajah lagos,9,5,4,5,1,1,0,1,8,3000000
5,ajah,allied garden estate badore ajah lagos,5,3,2,3,0,0,0,1,4,900000
6,ajah,silver point estate badore ajah lagos,5,3,2,3,0,0,0,1,4,900000
7,ajah,"  immediately after shoprite, sangotedo, lekki, lagos crown estate ajah lagos",9,5,4,5,1,1,0,1,8,3000000
8,ajah,by general paint olokonla ajah lagos,7,4,3,4,1,1,1,1,5,2500000
9,ajah,virgo estate badore ajah lagos,5,3,2,3,0,0,0,1,4,900000
10,ajah,unity estate badore ajah lagos,8,4,4,4,0,0,0,1,5,1200000
11,ajah,marshyhill eatate ado ajah lagos,7,4,3,4,0,0,0,1,5,1200000
12,ajah,happy land estate olokonla ajah lagos,9,5,4,5,1,1,0,1,8,3000000
13,ajah,marshyhill estate ado ajah lagos,7,4,3,4,0,0,0,1,5,1200000
14,ajah,inside estate badore ajah lagos,2,1,1,1,0,0,0,1,1,400000
15,ajah,badore ajah lagos,2,1,1,1,0,0,0,1,1,400000
16,ajah,- ado ajah lagos,2,1,1,1,0,0,0,1,1,400000
17,ajah,badore ajah lagos,3,2,1,2,1,1,0,1,4,800000
18,ajah,grenadine estate sangotedo ajah lagos,7,4,3,4,1,0,0,1,5,1400000
19,ajah,"  grenadine estate, by shoprite sangotedo ajah lagos",7,4,3,4,1,1,1,1,5,1700000
20,ajah,ado ajah lagos,7,4,3,4,1,0,0,1,5,1400000
21,ajah,"  abijo gra, lekki, lagos abijo ajah lagos",14,6,8,6,1,1,0,1,9,4000000
22,ajah,happy land estate olokonla ajah lagos,7,4,3,4,1,1,1,1,5,2000000
23,ajah,by blenco supermarket sangotedo ajah lagos,2,1,1,1,1,1,1,1,1,550000
24,ajah,mrs ajah lagos,8,4,4,4,0,0,0,1,5,1200000
25,ajah,"  salvation estate, off addo/langbasa road, ajah lagos",4,3,1,3,1,1,0,1,4,1000000
26,ajah,royal gardens ajiwe ajah lagos,11,6,5,6,1,1,0,1,9,4000000
27,ajah,badore ajah lagos,8,4,4,4,0,0,0,1,5,1200000
28,ajah,- badore ajah lagos,2,1,1,1,0,0,0,1,1,400000
29,ajah,"  royal garden estate, ajiwe ajah lagos",11,6,5,6,1,1,1,1,9,5000000
30,ajah,ado ajah lagos,9,5,4,5,1,1,0,1,8,3000000
31,ajah,ado ajah lagos,10,6,4,6,1,1,0,1,9,4000000
32,ajah,awoyaya ajah lagos,2,1,1,1,0,0,0,1,1,400000
33,ajah,infinity estate ado ajah lagos,8,4,4,4,0,0,0,1,5,1200000
34,ajah,"  mobil estate, ilaje off northwest filling station ilaje ajah lagos",9,5,4,5,1,1,0,1,8,3000000
35,ajah,- thomas estate ajah lagos,6,3,3,3,1,1,1,1,4,1500000
36,ajah,cooperative estate badore ajah lagos,7,4,3,4,0,0,0,1,5,1200000
37,ajah,mrs ajah lagos,4,2,2,2,1,1,0,1,4,800000
38,ajah,mobile road ilaje ajah lagos,5,3,2,3,1,1,1,1,4,1200000
39,ajah,silver point estate badore ajah lagos,5,3,2,3,1,1,1,1,4,2300000
40,ajah,abijo ajah lagos,2,1,1,1,0,0,0,1,1,400000
41,ajah,alpha bus stop sangotedo ajah lagos,3,2,1,2,1,1,0,1,4,800000
42,ajah,inside estate ado ajah lagos,6,3,3,3,0,0,0,1,4,900000
43,ajah,inside estate badore ajah lagos,2,1,1,1,0,0,0,1,1,400000
44,ajah,ado ajah lagos,4,2,2,2,1,1,0,1,4,800000
45,ajah,badore ajah lagos,9,5,4,5,1,1,0,1,8,3000000
46,ajah,shoprite monastery road sangotedo ajah lagos,9,5,4,5,1,1,0,1,8,3000000
47,ajah,good news estate sangotedo ajah lagos,7,4,3,4,1,0,0,1,5,1300000
48,ajah,diamond estate sangotedo ajah lagos,9,5,4,5,1,1,0,1,8,3000000
49,ajah,oke ira kekere ajah lagos,7,4,3,4,0,0,0,1,5,1200000
50,ajah,harmony estate ado ajah lagos,7,4,3,4,0,0,0,1,5,1200000
53,ajah,abraham adesanya estate ajah lagos,6,3,3,3,1,1,0,1,4,1000000
54,ajah,marshy hill estate akins ado ajah lagos,2,1,1,1,1,1,1,1,1,550000
55,ajah,general paint alasia ajah ajah lagos,9,5,4,5,1,1,0,1,8,3000000
56,ajah,thomas estate ajah thomas estate ajah lagos,5,3,2,3,0,0,0,1,4,900000
57,ajah,marina estate behind unity estate badore ajah badore ajah lagos,3,2,1,2,1,1,0,1,4,800000
58,ajah,marshy hill estate ado ajah lagos,2,1,1,1,0,0,0,1,1,400000
59,ajah,jubril estate olokonla just by lagos business school ajah olokonla ajah lagos,7,4,3,4,0,0,0,1,5,1200000
60,ajah,good news estate sangotedo ajah lagos,7,4,3,4,0,0,0,1,5,1200000
61,ajah,- abraham adesanya estate ajah lagos,2,1,1,1,1,0,0,1,1,450000
62,ajah,ilaje opposite vgc ilaje ajah lagos,7,4,3,4,1,1,1,1,5,1600000
63,ajah,good news estate sangotedo sangotedo ajah lagos,7,4,3,4,0,0,0,1,5,1200000
64,ajah,in an estate. badore ajah lagos,5,3,2,3,0,0,0,1,4,900000
65,ajah,marshy hill estate ado ajah lagos,7,4,3,4,0,0,0,1,5,1200000
66,ajah,by abraham adesanya estate lekki gardens estate ajah lagos,7,4,3,4,1,1,1,1,5,1600000
67,ajah,... abraham adesanya estate ajah lagos,4,2,2,2,1,1,1,1,4,900000
68,ajah,peaceville estate badore ajah lagos,9,5,4,5,1,1,0,1,8,3000000
69,ajah," harmony estate, langbasa ajah lagos",7,4,3,4,0,0,0,1,5,1200000
70,ajah," harmony estate, langbasa. ajah lagos",5,3,2,3,0,0,0,1,4,900000
71,ajah,crown estate sangotedo sangotedo ajah lagos,13,7,6,7,1,1,0,1,9,5000000
72,ajah,back of blenco supermarket sangotedo ajah lagos,5,3,2,3,1,1,1,1,4,1200000
73,ajah,rockstone estate after cooperative villa estate badore badore ajah lagos,5,3,2,3,0,0,0,1,4,900000
74,ajah,cooperative villa badore badore ajah lagos,5,3,2,3,0,0,0,1,4,900000
75,ajah,ajah lagos,7,4,3,4,0,0,0,1,5,1200000
76,ajah,badore ajah lagos,7,4,3,4,0,0,0,1,5,1200000
77,ajah,co-operation villa badore ajah lagos,5,3,2,3,0,0,0,1,4,900000
78,ajah,rockville estate badore ajah lagos,7,4,3,4,0,0,0,1,5,1200000
79,ajah,rockville estate badore ajah lagos,7,4,3,4,0,0,0,1,5,1200000
80,ajah,unity estate ado ajah lagos,7,4,3,4,0,0,0,1,5,1200000
81,ajah,virgo estate badore ajah lagos,7,4,3,4,0,0,0,1,5,1200000
82,ajah,pennisula estate sangotedo ajah lagos,7,4,3,4,0,0,0,1,5,1200000
83,ajah,goodnews estate sangotedo ajah lagos,7,4,3,4,1,0,0,1,5,1300000
84,ajah,greenville estate badore ajah lagos,7,4,3,4,0,0,0,1,5,1200000
85,ajah,even estate ado ajah lagos,5,3,2,3,0,0,0,1,4,900000
86,ajah,royal palm estate badore ajah lagos,2,1,1,1,1,1,1,1,1,500000
87,ajah,ajah lagos,9,5,4,5,1,1,0,1,8,3000000
88,ajah,greenville estate badore ajah lagos,9,5,4,5,1,1,0,1,8,3000000
89,ajah,badore ajah lagos,8,4,4,4,0,0,0,1,5,1200000
90,ajah,badore ajah lagos,6,3,3,3,0,0,0,1,4,900000
91,ajah,ado ajah lagos,5,3,2,3,0,0,0,1,4,950000
92,ajah,"lekki garden phase 2,opposite abraham adesanya abraham adesanya estate ajah lagos",7,4,3,4,1,1,1,1,5,1500000
93,ajah,badore ajah lagos,6,3,3,3,0,0,0,1,4,900000
94,ajah,... badore ajah lagos,6,3,3,3,0,0,0,1,4,900000
95,ajah,silverpoint estate badore ajah lagos,5,3,2,3,0,0,0,1,4,900000
96,ajah,hitech estate sangotedo ajah lagos,7,4,3,4,1,0,0,1,5,1300000
97,ajah,ado ajah lagos,9,5,4,5,1,1,0,1,8,3000000
98,ajah,mobile ajah lagos,9,5,4,5,1,1,0,1,8,3000000
99,ajah,green vill estate badore ajah lagos,6,3,3,3,0,0,0,1,4,900000
100,ajah,sangotedo ajah lagos,2,1,1,1,0,0,0,1,1,400000
101,ajah,badore ajah lagos,4,2,2,2,1,1,0,1,4,800000
102,ajah,badore ajah lagos,2,1,1,1,0,0,0,1,1,400000
103,ajah,- sangotedo ajah lagos,7,4,3,4,1,1,1,1,5,1500000
104,ajah,badore ajah lagos,6,3,3,3,1,1,1,1,4,1100000
105,ajah,greenville badore ajah lagos,3,2,1,2,1,1,0,1,4,800000
106,ajah,ogombo ajah lagos,2,1,1,1,1,1,1,1,1,550000
107,ajah," off mobil road, ilaje ajah lagos",7,4,3,4,0,0,0,1,5,1200000
108,ajah,badore ajah lagos,2,1,1,1,0,0,0,1,1,400000
109,ajah,awoyaya ajah lagos,9,5,4,5,1,1,0,1,8,3000000
110,ajah," fatai kaffo street,happy land estate olokonla ajah lagos",7,4,3,4,0,0,0,1,5,1200000
111,ajah,mobil estate (emerald estate) ilaje ajah lagos,9,5,4,5,1,1,0,1,8,3000000
112,ajah,- sangotedo ajah lagos,6,3,3,3,1,1,1,1,4,1200000
113,ajah,badore ajah lagos,6,3,3,3,0,0,0,1,4,900000
114,ajah,badore ajah lagos,6,3,3,3,0,0,0,1,4,900000
115,ajah,badore ajah lagos,6,3,3,3,0,0,0,1,4,900000
116,ajah," lucky osujie, lekki palm city estate ado ajah lagos",9,5,4,5,1,1,0,1,8,3000000
117,ajah,- ado ajah lagos,6,3,3,3,0,0,0,1,4,900000
118,ajah,badore ajah lagos,4,2,2,2,1,1,0,1,4,800000
119,ajah,emerald estate off mobil road ilaje ajah lagos,11,6,5,6,1,1,0,1,9,4000000
120,ajah,badore ajah lagos,6,3,3,3,0,0,0,1,4,900000
121,ajah,ado ajah lagos,2,1,1,1,0,0,0,1,1,400000
122,ajah,awoyaya ajah lagos,8,4,4,4,0,0,0,1,5,1200000
123,ajah,awoyaya ajah lagos,4,2,2,2,1,1,0,1,4,800000
124,ajah," salvation estate off addo/langbasa road, ajah lagos",3,2,1,2,1,1,0,1,4,800000
125,ajah,... badore ajah lagos,2,1,1,1,0,0,0,1,1,400000
126,ajah,badore ajah lagos,5,3,2,3,0,0,0,1,4,900000
127,ajah,badore ajah lagos,6,3,3,3,0,0,0,1,4,900000
128,ajah,alasela ogombo ajah lagos,4,2,2,2,1,1,0,1,4,800000
129,ajah,ado ajah lagos,5,3,2,3,1,1,0,1,4,1000000
130,ajah,ado ajah lagos,4,2,2,2,1,1,0,1,4,800000
131,ajah,badore ajah lagos,3,2,1,2,1,1,0,1,4,800000
132,ajah,badore ajah lagos,4,2,2,2,1,1,0,1,4,800000
133,ajah,badore ajah lagos,2,1,1,1,0,0,0,1,1,400000
134,ajah,badore ajah lagos,6,3,3,3,0,0,0,1,4,900000
135,ajah,greenville estate badore ajah lagos,7,4,3,4,0,0,0,1,5,1200000
136,ajah,badore ajah lagos,6,3,3,3,0,0,0,1,4,900000
137,ajah,badore ajah lagos,6,3,3,3,0,0,0,1,4,900000
138,ajah,badore ajah lagos,4,2,2,2,1,1,0,1,4,800000
139,ajah,... badore ajah lagos,9,5,4,5,1,1,0,1,8,3000000
140,ajah,greenville estate badore ajah lagos,5,3,2,3,0,0,0,1,4,900000
141,ajah,mobile ajah lagos,9,5,4,5,1,1,0,1,8,3000000
142,ajah,ado ajah lagos,9,5,4,5,1,1,0,1,8,3000000
143,ajah,lekki scheme 2 ajah lagos,9,5,4,5,1,1,0,1,8,3000000
144,ajah,lekki scheme 2 ajah lagos,9,5,4,5,1,1,0,1,8,3000000
145,ajah,lekki scheme 2 ajah lagos,7,4,3,4,1,1,1,1,5,1500000
146,ajah,- badore ajah lagos,4,2,2,2,1,1,0,1,4,800000
147,ajah,badore ajah lagos,6,3,3,3,0,0,0,1,4,900000
148,ajah,ado ajah lagos,4,2,2,2,1,1,0,1,4,800000
149,ajah,- badore ajah lagos,2,1,1,1,0,0,0,1,1,400000
150,ajah,ado ajah lagos,4,2,2,2,1,1,0,1,4,800000
151,ajah,badore ajah lagos,2,1,1,1,0,0,0,1,1,400000
152,ajah,lamgbasa ado ajah lagos,5,3,2,3,1,1,0,1,4,1000000
153,ajah,abraham adesanya estate ajah lagos,6,3,3,3,1,1,1,1,4,1500000
154,ajah,alaguntan ajah lagos,7,4,3,4,1,1,1,1,5,2000000
155,ajah,ajah lagos,9,5,4,5,1,1,0,1,8,3000000
156,ajah,.. sangotedo ajah lagos,7,4,3,4,0,0,0,1,5,1200000
157,ajah,badore ajah lagos,2,1,1,1,0,0,0,1,1,400000
158,ajah,badore ajah lagos,6,3,3,3,0,0,0,1,4,900000
159,ajah,... badore ajah lagos,8,4,4,4,0,0,0,1,5,1200000
160,ajah,by lekki gardens phase 2 abraham adesanya estate ajah lagos,7,4,3,4,1,1,1,1,5,2000000
161,ajah,ado ajah lagos,11,6,5,6,1,1,0,1,9,4000000
162,ajah,badore ajah lagos,6,3,3,3,0,0,0,1,4,900000
163,ajah,badore ajah lagos,4,2,2,2,1,1,0,1,4,800000
164,ajah,gold in estate badore ajah lagos,6,3,3,3,0,0,0,1,4,900000
165,ajah,badore ajah lagos,6,3,3,3,0,0,0,1,4,900000
166,ajah,thomas estate ajah lagos,6,3,3,3,1,1,0,1,4,1000000
167,ajah," idowu estate, oke ira ado ajah lagos",5,3,2,3,0,0,0,1,4,900000
168,ajah,- sangotedo ajah lagos,5,3,2,3,1,1,1,1,4,1300000
169,ajah,lbs ajah lagos,7,4,3,4,0,0,0,1,5,1200000
170,ajah,badore ajah lagos,6,3,3,3,0,0,0,1,4,900000
171,ajah,badore ajah lagos,2,1,1,1,0,0,0,1,1,400000
172,ajah,facing locuse army on ado road ado ajah lagos,6,3,3,3,0,0,0,1,4,900000
173,ajah,abraham adesanya estate ajah lagos,7,4,3,4,1,1,1,1,5,1500000
174,ajah,.. abraham adesanya estate ajah lagos,7,4,3,4,1,1,1,1,5,1500000
175,ajah,- sangotedo ajah lagos,5,3,2,3,1,1,1,1,4,1300000
176,ajah,- sangotedo ajah lagos,7,4,3,4,0,0,0,1,5,1200000
177,ajah,sangotedo ajah lagos,9,5,4,5,1,1,0,1,8,3000000
178,ajah,sangotedo ajah lagos,9,5,4,5,1,1,1,1,8,5000000
179,ajah,sangotedo ajah lagos,15,8,7,8,1,1,0,1,10,5500000
180,ajah,badore ajah lagos,4,2,2,2,1,1,0,1,4,800000
181,ajah,badore ajah lagos,8,4,4,4,1,1,1,1,5,1500000
182,ajah,badore ajah lagos,8,4,4,4,0,0,0,1,5,1200000
183,ajah,lbs sangotedo ajah lagos,15,8,7,8,1,1,0,1,10,5500000
184,ajah," mobil road, ilaje ajah lagos",9,5,4,5,1,1,0,1,8,3000000
185,ajah," opposite eco bank, pavilion estate ado road ajah ado ajah lagos",9,5,4,5,1,1,0,1,8,3000000
186,ajah,badore ajah lagos,8,4,4,4,0,0,0,1,5,1200000
187,ajah,badore ajah lagos,6,3,3,3,0,0,0,1,4,900000
188,ajah,badore ajah lagos,6,3,3,3,0,0,0,1,4,900000
189,ajah,... badore ajah lagos,6,3,3,3,0,0,0,1,4,900000
190,ajah,badore ajah lagos,5,3,2,3,0,0,0,1,4,900000
191,ajah,thomas estate thomas estate ajah lagos,7,4,3,4,1,1,1,1,5,2000000
192,ajah,sangotedo ajah lagos,5,3,2,3,1,1,1,1,4,1200000
193,ajah,... thomas estate ajah lagos,4,2,2,2,1,1,0,1,4,800000
194,ajah,badore ajah lagos,2,1,1,1,0,0,0,1,1,400000
195,ajah,badore ajah lagos,2,1,1,1,0,0,0,1,1,400000
196,ajah,kajola after lakwe lakowe ajah lagos,2,1,1,1,0,0,0,1,1,400000
197,ajah,gbetu road awoyaya off lekki epe expressway ajah lagos,12,6,6,6,1,1,0,1,9,4000000
198,ajah,west wood street. badore ajah lagos,2,1,1,1,0,0,0,1,1,400000
199,ajah,badore ajah lagos,3,2,1,2,1,1,0,1,4,800000
200,ajah,ado ajah lagos,5,3,2,3,0,0,0,1,4,900000
201,ajah,mobil road ilaje ajah lagos,9,5,4,5,1,1,0,1,8,3000000
202,ajah," harmony estate, ajah badagry badagry lagos",4,2,2,2,1,1,0,1,4,800000
203,ajah,victory park thomas estate ajah lagos,11,6,5,6,1,1,0,1,9,4000000
204,ajah,by lagos business school olokonla ajah lagos,3,2,1,2,1,1,0,1,4,800000
205,ajah,alaguntan ilaje ajah lagos,11,6,5,6,1,1,0,1,9,4000000
206,ajah,safecourt estate badore ajah lagos,7,4,3,4,1,1,1,1,5,3000000
207,ajah,lekki scheme 2 ogombo ajah lagos,9,5,4,5,1,1,0,1,8,3000000
208,ajah,badore ajah lagos,9,5,4,5,1,1,0,1,8,3000000
209,ajah,.. thomas estate ajah lagos,5,3,2,3,1,1,0,1,4,1000000
210,ajah,peninsula garden estate sangotedo ajah lagos,9,5,4,5,1,1,0,1,8,3000000
211,ajah,lagos business school olokonla ajah lagos,5,3,2,3,1,1,1,1,4,1200000
212,ajah,golden pearls estate sangotedo ajah lagos,11,6,5,6,1,1,0,1,9,4000000
213,ajah,mobil estate ilaje ajah lagos,9,5,4,5,1,1,0,1,8,3000000
214,ajah,alhaji folami street off mobil road illaje ajah ilaje ajah lagos,7,4,3,4,0,0,0,1,5,1200000
215,ajah," unity avenue estate, pump and sell addo road ajah ado ajah lagos",6,3,3,3,1,1,1,1,4,1200000
216,ajah,off mobil road illaje ajah ilaje ajah lagos,5,3,2,3,1,1,0,1,4,1000000
217,ajah,orile maroko estate opposite emerald estate mobil road illaje ajah ilaje ajah lagos,8,3,5,3,1,1,0,1,4,1000000
218,ajah,ado ajah lagos,5,3,2,3,0,0,0,1,4,900000
219,ajah,ado ajah lagos,5,3,2,3,0,0,0,1,4,900000
220,ajah,off mobile road ajiwe ajah lagos,4,2,2,2,1,1,1,1,4,1000000
221,ajah,badore ajah lagos,9,4,5,4,0,0,0,1,5,1200000
222,ajah,thomas estate ajah lagos,9,5,4,5,1,1,0,1,8,3000000
223,ajah,thomas estate ajah lagos,9,5,4,5,1,1,0,1,8,3000000
224,ajah,harmony estate lanbasa ado ajah lagos,8,4,4,4,0,0,0,1,5,1200000
225,ajah,badore ajah lagos,9,5,4,5,1,1,0,1,8,3000000
226,ajah,awoyaya awoyaya ajah lagos,9,5,4,5,1,1,0,1,8,3000000
227,ajah,abraham adesanya estate ajah lagos,2,1,1,1,0,0,0,1,1,400000
228,ajah," langbasa, addo road. ajah. ado ajah lagos",6,3,3,3,0,0,0,1,4,900000
229,ajah," greenville estate badore, ajah badore ajah lagos",6,3,3,3,0,0,0,1,4,900000
230,ajah,ajah lagos,12,6,6,6,1,1,0,1,9,4000000
231,ajah,ajah lagos,6,3,3,3,1,1,0,1,4,1000000
232,ajah,ajah lagos,10,5,5,5,1,1,1,1,8,5000000
233,ajah,ado ajah lagos,5,3,2,3,0,0,0,1,4,950000
234,ajah,mobil road immediately after emerald estate ilaje ajah lagos,7,4,3,4,0,0,0,1,5,1200000
235,ajah,value county estate near lagos business school off lekki epe expressway ajah lagos,8,4,4,4,1,0,0,1,5,1300000
236,ajah,after lbs in olokonla in ajah axis lekki. olokonla ajah lagos,7,4,3,4,0,0,0,1,5,1200000
237,ajah,opp ikota villa before ajah in lekki. lekki phase 2 lekki lagos,4,2,2,2,1,1,0,1,4,850000
238,ajah,ado ajah lagos,7,4,3,4,0,0,0,1,5,1200000
239,ajah,ado ajah lagos,7,4,3,4,0,0,0,1,5,1200000
240,ajah,peace estate badore ajah lagos,3,2,1,2,1,1,0,1,4,800000
241,ajah,ajah lagos,2,1,1,1,0,0,0,1,1,400000
242,ajah,ado ajah lagos,4,2,2,2,1,1,1,1,4,900000
243,ajah,remlek estate badore ajah badore ajah lagos,4,2,2,2,1,1,0,1,4,800000
244,ajah,badore ajah lagos,3,2,1,2,1,1,0,1,4,800000
245,ajah,badore ajah lagos,3,2,1,2,1,1,0,1,4,800000
246,ajah,badore ajah lagos,3,2,1,2,1,1,0,1,4,800000
247,ajah," iyabus plaza pump and sell area, ado ajah lagos",6,3,3,3,0,0,0,1,4,900000
248,ajah,ado ajah lagos,4,2,2,2,1,1,0,1,4,800000
249,ajah,badore ajah lagos,4,2,2,2,1,1,0,1,4,800000
250,ajah,badore ajah lagos,2,1,1,1,0,0,0,1,1,400000
251,ajah,thomas estates thomas estate ajah lagos,3,2,1,2,1,1,0,1,4,800000
252,ajah,orile maroko estate opp emerald estate mobil road illaje ajah ilaje ajah lagos,6,3,3,3,0,0,0,1,4,900000
253,ajah,ajiwe ajah lagos,4,2,2,2,1,1,1,1,4,1300000
254,ajah,badore ajah lagos,6,3,3,3,0,0,0,1,4,900000
255,ajah,around blenco supermarket before sangotedo. peninsula estate ajah lagos,7,4,3,4,1,1,1,1,5,2000000
256,ajah,around blenco supermarket before sangotedo in ajah axis lekki. peninsula estate ajah lagos,3,2,1,2,1,1,0,1,4,800000
257,ajah,after blenco supermarket before sangotedo market in ajah axis lekki. sangotedo ajah lagos,7,4,3,4,0,0,0,1,5,1200000
258,ajah,fidiso estate in kingdom hall road in abijo in ajah axis lekki. abijo ajah lagos,2,1,1,1,0,0,0,1,1,400000
259,ajah,after blenco supermarket before sangotedo market in ajah axis lekki. sangotedo ajah lagos,9,5,4,5,1,1,0,1,8,3000000
260,ajah,majek sangotedo in ajah axis lekki. sangotedo ajah lagos,3,2,1,2,1,1,0,1,4,800000
261,ajah,opp sangotedo market in ajah axis lekki. sangotedo ajah lagos,5,3,2,3,0,0,0,1,4,900000
262,ajah,opp sangotedo market in ajah axis lekki. sangotedo ajah lagos,7,4,3,4,0,0,0,1,5,1200000
263,ajah,abijo ajah lagos,2,1,1,1,1,0,0,1,1,450000
264,ajah,seaside estate badore ajah lagos,5,3,2,3,0,0,0,1,4,900000
265,ajah,ado and environs ado ajah lagos,6,3,3,3,0,0,0,1,4,900000
266,ajah,ado ajah lagos,6,3,3,3,0,0,0,1,4,900000
267,ajah,ado and environs ado ajah lagos,6,3,3,3,0,0,0,1,4,900000
268,ajah,abraham adesanya estate ajah lagos,10,5,5,5,1,1,0,1,8,3000000
269,ajah,majek sangotedo ajah lagos,2,1,1,1,0,0,0,1,1,400000
270,ajah,thomas estate ajah lagos,5,2,3,2,1,1,0,1,4,800000
271,ajah,abraham adesanya estate ajah lagos,2,1,1,1,1,1,1,1,1,1000000
272,ajah,abraham adesanya estate ajah lagos,4,2,2,2,1,1,0,1,4,800000
273,ajah,thomas estate ajah lagos,4,2,2,2,1,1,0,1,4,800000
274,ajah,thomas estate ajah lagos,3,2,1,2,1,1,0,1,4,800000
275,ajah,badore ajah lagos,5,3,2,3,0,0,0,1,4,900000
276,ajah,mobil road illaje ajah lagos state ilaje ajah lagos,9,5,4,5,1,1,1,1,8,5000000
277,ajah,good news estate sangotedo ajah lagos,10,5,5,5,1,1,1,1,8,5000000
278,ajah,lekki garden estate phase 4 lekki gardens estate ajah lagos,9,5,4,5,1,1,0,1,8,3000000
279,ajah,ajiwe ajah lagos,9,5,4,5,1,1,0,1,8,3000000
280,ajah,behind the new shoprite in sangotedo in ajah axis lekki. sangotedo ajah lagos,10,5,5,5,1,1,0,1,8,3000000
281,ajah,pump and sell bustop addo road ajah ado ajah lagos,5,3,2,3,0,0,0,1,4,900000
282,ajah,lekki palm city estate off lekki epe expressway ajah lagos,7,4,3,4,1,1,1,1,5,1700000
283,ajah,greenville estate badore ajah badore ajah lagos,2,1,1,1,1,1,1,1,1,500000
284,ajah,badore ajah lagos,4,2,2,2,1,1,1,1,4,1000000
285,ajah,off addo road marshy hill estate ado ajah lagos,6,3,3,3,1,1,1,1,4,1200000
286,ajah,bakery bustop opp rockstone estate badore road ajah badore ajah lagos,5,3,2,3,0,0,0,1,4,900000
287,ajah,before blenco supermarket in olokonla in ajah axis lekki. olokonla ajah lagos,10,5,5,5,1,1,0,1,8,3000000
288,ajah,pump and sell addo road ajah ado ajah lagos,7,4,3,4,0,0,0,1,5,1200000
289,ajah,off mobile road ajah lagos,4,2,2,2,1,1,1,1,4,1000000
290,ajah,marshy hill estate akins bustop addo road ajah ado ajah lagos,2,1,1,1,0,0,0,1,1,400000
291,ajah,marshy hill estate ado ajah lagos,7,4,3,4,0,0,0,1,5,1200000
292,ajah," ologunfe, awoyaya ajah lagos",7,4,3,4,0,0,0,1,5,1200000
293,ajah,mobil road ilaje ajah lagos,8,4,4,4,1,1,1,1,5,1500000
294,ajah,majek opp fara park after crown estate in sangotedo in ajah axis lekki. crown estate ajah lagos,8,4,4,4,0,0,0,1,5,1200000
295,ajah,ogombo ajah lagos,9,5,4,5,1,1,0,1,8,3000000
296,ajah,greenville estate badore ajah badore ajah lagos,5,3,2,3,0,0,0,1,4,900000
297,ajah,lekki palms estate lavalon hotel estate off addo road ajah ado ajah lagos,9,5,4,5,1,1,0,1,8,3000000
298,ajah,esfort estate opp mfm ajah off addo road ajah ado ajah lagos,9,5,4,5,1,1,0,1,8,3000000
299,ajah,marshy hill estate ado ajah lagos,7,4,3,4,1,0,0,1,5,1300000
300,ajah,before fara park after crown estate in sangotedo in ajah axis. crown estate ajah lagos,11,6,5,6,1,1,0,1,9,4000000
301,ajah," around crown estate, sangotedo, ajah axis, lekki. sangotedo ajah lagos",6,3,3,3,1,1,0,1,4,1000000
302,ajah,greenville estate badore ajah badore ajah lagos,5,3,2,3,0,0,0,1,4,900000
303,ajah,within an estate sangotedo ajah lagos,7,4,3,4,0,0,0,1,5,1200000
304,ajah," gated estate, addo road ado ajah lagos",5,3,2,3,1,1,0,1,4,1000000
305,ajah," gated estate, addo road ado ajah lagos",5,3,2,3,1,1,0,1,4,1000000
306,ajah,ajah ajah lagos,2,1,1,1,0,0,0,1,1,400000
307,ajah,greenville estate badore ajah lagos,4,2,2,2,1,1,0,1,4,800000
308,ajah,ado ado ajah lagos,5,3,2,3,0,0,0,1,4,900000
309,ajah,ajah lagos,6,3,3,3,1,1,0,1,4,1000000
310,ajah,gated street by junction/harmony estate bustop langbasa road addo ajah ado ajah lagos,4,2,2,2,1,1,0,1,4,800000
311,ajah,before sangotedo market in sangotedo in ajah axis lekki. sangotedo ajah lagos,6,3,3,3,0,0,0,1,4,900000
312,ajah,ajah lagos,4,2,2,2,1,1,0,1,4,800000
313,ajah,chinese road junction bustop addo - langbasa rd ajah ado ajah lagos,5,3,2,3,0,0,0,1,4,900000
314,ajah,around the new shoprite in sangotedo in ajah axis lekki. sangotedo ajah lagos,10,5,5,5,1,1,0,1,8,3000000
315,ajah,remlek estate badore ajah badore ajah lagos,2,1,1,1,1,1,1,1,1,500000
316,ajah,greenville estate badore ajah badore ajah lagos,2,1,1,1,0,0,0,1,1,400000
317,ajah,greenville estate badore ajah badore ajah lagos,2,1,1,1,1,1,1,1,1,500000
318,ajah,teran x estate near bleco super market olokonla ajah lagos,5,3,2,3,1,1,1,1,4,1100000
319,ajah,elegant court estate mobil road illaje ajah ilaje ajah lagos,7,4,3,4,0,0,0,1,5,1200000
320,ajah,royal palm will estate remlek badore ajah lagos,5,3,2,3,0,0,0,1,4,900000
321,ajah," majek, after crown estate in ajah axis lekki. crown estate ajah lagos",8,4,4,4,0,0,0,1,5,1200000
322,ajah,peninsula estate ajah lagos,7,4,3,4,1,1,1,1,5,1600000
323,ajah,anu crescent estate badore ajah lagos,4,2,2,2,1,1,1,1,4,1000000
324,ajah,powerline estate opp sunny villa estate badore ajah badore ajah lagos,5,3,2,3,0,0,0,1,4,900000
325,ajah," onison street, lakowe lakowe ajah lagos",5,3,2,3,0,0,0,1,4,900000
326,ajah,anu crescent badore ajah lekki badore ajah lagos,4,2,2,2,1,1,1,1,4,1000000
327,ajah,ajah lagos,4,2,2,2,1,1,0,1,4,800000
328,ajah,ogunfayo ibeju-lekki sangotedo ajah lagos,2,1,1,1,0,0,0,1,1,400000
329,ajah," cooperative villa road, badore badore ajah lagos",12,6,6,6,1,1,0,1,9,4000000
330,ajah,red roof bustop langbasa road ajah ado ajah lagos,3,2,1,2,1,1,0,1,4,800000
331,ajah,majek opp fara park after crown estate in ajah axis lekki. crown estate ajah lagos,2,1,1,1,0,0,0,1,1,400000
332,ajah,greenville estate badore ajah badore ajah lagos,2,1,1,1,0,0,0,1,1,400000
333,ajah," mayfair garden, awoyaya, ajah axis lekki. awoyaya ajah lagos",8,4,4,4,1,1,1,1,5,1500000
334,ajah,marshy hill estate akins bustop off addo road ajah ado ajah lagos,7,4,3,4,0,0,0,1,5,1200000
335,ajah,an estate in abijo after crown estate in ajah axis lekki. abijo ajah lagos,6,3,3,3,0,0,0,1,4,900000
336,ajah,ajah ajah lagos,2,1,1,1,0,0,0,1,1,400000
337,ajah,ajah lagos,6,3,3,3,1,1,0,1,4,1000000
338,ajah,badore ajah lagos,6,3,3,3,0,0,0,1,4,900000
339,ajah," within an estate, off ado road. ado ajah lagos",7,4,3,4,0,0,0,1,5,1200000
340,ajah,gated street by junction bustop opp harmony estate langbasa road ajah ado ajah lagos,5,3,2,3,0,0,0,1,4,900000
341,ajah," blenco supermarket before sangotedo, after lbs. peninsula estate ajah lagos",9,5,4,5,1,1,0,1,8,3000000
342,ajah,meridian luxury park estate awoyaya ajah lagos,7,4,3,4,0,0,0,1,5,1200000
343,ajah,.. sangotedo ajah lagos,6,3,3,3,1,1,1,1,4,1400000
344,ajah," majek after fara park, after crown estate in ajah axis lekki. crown estate ajah lagos",8,4,4,4,0,0,0,1,5,1200000
345,ajah," behind abraham adesanya round about, ajah lagos",11,6,5,6,1,1,0,1,9,4000000
346,ajah,lagum view estate opp catholic church ajah lagos,12,6,6,6,1,1,0,1,9,4000000
347,ajah,before blenco supermarket before sangotedo in ajah axis lekki. olokonla ajah lagos,6,3,3,3,0,0,0,1,4,900000
348,ajah,emerald housing estate ilaje ajah lagos,8,4,4,4,1,1,1,1,5,2500000
349,ajah,general paint bus stop just by abraham adesanya estate abraham adesanya estate ajah lagos,9,5,4,5,1,1,0,1,8,3000000
350,ajah,sangotedo sangotedo ajah lagos,7,4,3,4,1,0,0,1,5,1300000
351,ajah,lekki scheme 2 ajiwe ajah lagos,10,5,5,5,1,1,0,1,8,3000000
352,ajah,after lbs in olokonla in ajah axis lekki. olokonla ajah lagos,6,3,3,3,0,0,0,1,4,900000
353,ajah,olokonla olokonla ajah lagos,7,4,3,4,0,0,0,1,5,1200000
354,ajah,loshoro..school gate badore ajah lagos,2,1,1,1,0,0,0,1,1,400000
355,ajah,reservation estate langbasa road owode addo ajah ado ajah lagos,5,3,2,3,1,1,0,1,4,1000000
356,ajah,off mobil road ilaje ajah lagos,4,2,2,2,1,1,1,1,4,1000000
357,ajah,sangotedo ajah lagos,4,2,2,2,1,1,0,1,4,800000
358,ajah,awoyaya bus stop awoyaya ajah lagos,7,4,3,4,0,0,0,1,5,1200000
359,ajah,sangotedo ajah lagos,6,3,3,3,0,0,0,1,4,900000
360,ajah,red roof bustop addo - langbasa rd ajah ado ajah lagos,3,2,1,2,1,1,0,1,4,800000
361,ajah,greenville estate badore ajah badore ajah lagos,2,1,1,1,1,1,1,1,1,500000
362,ajah,crown estate crown estate ajah lagos,8,4,4,4,1,1,1,1,5,3000000
363,ajah,esfort estate addo road ajah ado ajah lagos,2,1,1,1,1,1,1,1,1,700000
364,ajah,estate after crown estate in ajah axis lekki. abijo ajah lagos,6,3,3,3,0,0,0,1,4,900000
365,ajah," abraham adesanya estate, ajah lagos",2,1,1,1,0,0,0,1,1,400000
366,ajah,marshy hill estate ado ajah lagos,7,4,3,4,0,0,0,1,5,1200000
367,ajah,chevron alternative ajah lagos,9,5,4,5,1,1,1,1,8,3500000
368,ajah,gated estate opp emerald estate mobil road illaje ajah ilaje ajah lagos,5,3,2,3,0,0,0,1,4,900000
369,ajah," destiny homes estate in abijo, after fara park, after crown estate in ajah axis lekki. crown estate ajah lagos",8,4,4,4,0,0,0,1,5,1200000
370,ajah,ajose street badore ajah badore ajah lagos,7,4,3,4,0,0,0,1,5,1250000
371,ajah,gated street by junction bustop harmony estate langbasa rd ajah ado ajah lagos,3,2,1,2,1,1,0,1,4,800000
372,ajah,ajah lagos,6,3,3,3,1,1,1,1,4,1500000
373,ajah,gated estate by junction bustop facing harmony estate langbasa road ajah ado ajah lagos,5,3,2,3,0,0,0,1,4,900000
374,ajah,remlek estate badore ajah badore ajah lagos,7,4,3,4,0,0,0,1,5,1200000
375,ajah,omoba bade street marshy hill estate ado ajah lagos,7,4,3,4,0,0,0,1,5,1200000
376,ajah,ocean palm estate sangotedo ajah lagos,5,3,2,3,1,1,1,1,4,1100000
377,ajah,unity estate maryland badore ajah badore ajah lagos,9,5,4,5,1,1,0,1,8,3000000
378,ajah,pearl garden estate sangotedo ajah lagos,9,5,4,5,1,1,0,1,8,3000000
379,ajah,greenville estate badore ajah badore ajah lagos,5,3,2,3,0,0,0,1,4,900000
380,ajah,marshy hill estate addo road ajah ado ajah lagos,2,1,1,1,1,0,0,1,1,450000
381,ajah,before the new shoprite in sangotedo in ajah axis lekki. sangotedo ajah lagos,8,4,4,4,0,0,0,1,5,1200000
382,ajah,golf road lakowe lakowe ajah lagos,8,4,4,4,1,1,1,1,5,3000000
383,ajah," crown estate, sangotedo, ajah axis lekki. crown estate ajah lagos",8,4,4,4,1,1,1,1,5,1500000
384,ajah,green ville estate badore ajah lagos,2,1,1,1,1,1,1,1,1,500000
385,ajah,thomas estate thomas estate ajah lagos,6,3,3,3,1,1,1,1,4,1600000
386,ajah," infinity estate, ado road. ado ajah lagos",5,3,2,3,1,1,1,1,4,1500000
387,ajah,seaside estate badore ajah lagos,5,3,2,3,0,0,0,1,4,900000
388,ajah,by hot bread sangotedo ajah lagos,2,1,1,1,0,0,0,1,1,400000
389,ajah," united estate, sangotedo ajah lagos",7,4,3,4,0,0,0,1,5,1200000
390,ajah,divine homes estate thomas estate ajah lagos,9,5,4,5,1,1,0,1,8,3000000
391,ajah,an estate in abijo after crown estate in ajah axis lekki. abijo ajah lagos,6,3,3,3,0,0,0,1,4,900000
392,ajah,peace estate cocacola bustop badore ajah badore ajah lagos,3,2,1,2,1,1,0,1,4,800000
393,ajah,apteck rd sangotedo ajah lagos,7,4,3,4,0,0,0,1,5,1200000
394,ajah,within a very secure and peaceful estate ado ajah lagos,7,4,3,4,0,0,0,1,5,1200000
395,ajah,behind the new shoprite in sangotedo in ajah axis lekki. sangotedo ajah lagos,10,5,5,5,1,1,0,1,8,3000000
396,ajah,lavalon hotel road opp eco bank addo road ajah ado ajah lagos,5,3,2,3,1,1,0,1,4,1000000
397,ajah,abijo ajah lagos,11,6,5,6,1,1,1,1,9,5000000
398,ajah,unity estate maryland badore ajah badore ajah lagos,2,1,1,1,0,0,0,1,1,400000
399,ajah," around blenco supermarket before sangotedo, ajah axis lekki. sangotedo ajah lagos",10,5,5,5,1,1,0,1,8,3000000
400,ajah,illaje off emerald estate mobil road illaje ajah ilaje ajah lagos,7,4,3,4,1,1,1,1,5,1500000
401,ajah,ajah lagos,6,3,3,3,1,1,1,1,4,1700000
402,ajah,marshy hill estate akins bustop addo road ajah ado ajah lagos,5,3,2,3,0,0,0,1,4,950000
403,ajah,lekki palm city estate ado ajah lagos,8,4,4,4,1,1,1,1,5,2300000
404,ajah," united estate, sangotedo, ajah axis, lekki. sangotedo ajah lagos",6,3,3,3,0,0,0,1,4,900000
405,ajah,harmony estate langbasa rd ajah ado ajah lagos,9,5,4,5,1,1,0,1,8,3000000
406,ajah,berulah estate by addo round about addo ajah ado ajah lagos,5,3,2,3,0,0,0,1,4,900000
407,ajah,seaside estate ajah lagos,6,3,3,3,1,1,0,1,4,1000000
408,ajah,silverpoint estate badore ajah lagos,5,3,2,3,0,0,0,1,4,900000
409,ajah," lekki palm city estate, off ado road, ajah, lagos. badore ajah lagos",9,5,4,5,1,1,0,1,8,3000000
410,ajah," otunla street, lakowe lakowe ajah lagos",5,3,2,3,0,0,0,1,4,900000
411,ajah,lavalon hotel estate opp eco bank addo road ajah ado ajah lagos,7,4,3,4,1,0,0,1,5,1300000
412,ajah,ajah lagos,6,3,3,3,1,1,1,1,4,2300000
413,ajah,before blenco supermarket in olokonla in ajah axis lekki. olokonla ajah lagos,6,3,3,3,0,0,0,1,4,900000
414,ajah,harmony estate langbasa rd ajah ado ajah lagos,5,3,2,3,0,0,0,1,4,900000
415,ajah,mega estate black gate bustop badore ajah badore ajah lagos,7,4,3,4,1,0,0,1,5,1300000
416,ajah,royal garden estate ajah lagos,10,5,5,5,1,1,1,1,8,4000000
417,ajah,general paint bus stop sangotedo ajah lagos,11,5,6,5,1,1,0,1,8,3000000
418,ajah,beside lagos business school ajah lagos,7,4,3,4,1,0,0,1,5,1300000
419,ajah,gated mobile road opposite llaje bf ajah bridge ilaje ajah lagos,4,2,2,2,1,1,1,1,4,1200000
420,ajah," majek after fara park, after crown estate in ajah axis lekki. crown estate ajah lagos",6,3,3,3,0,0,0,1,4,900000
421,ajah," majek, opposite fara park, in ajah axis lekki. crown estate ajah lagos",4,2,2,2,1,1,0,1,4,800000
422,ajah," united estate, sangotedo, ajah axis, lekki. sangotedo ajah lagos",4,2,2,2,1,1,0,1,4,800000
423,ajah,ajah lagos,6,3,3,3,1,1,1,1,4,1600000
424,ajah,lekki scheme 2 abraham adesanya ogombo road ajah ogombo ajah lagos,5,3,2,3,1,1,0,1,4,1000000
425,ajah,westwood estate badore ajah lagos,2,1,1,1,1,1,1,1,1,600000
426,ajah,lekki scheme 2 abraham adesanya ogombo road ajah ilaje ajah lagos,7,4,3,4,1,1,1,1,5,1500000
427,ajah,unity estate maryland badore ajah badore ajah lagos,7,4,3,4,0,0,0,1,5,1200000
428,ajah,thera annex sangotedo ajah lagos,5,3,2,3,0,0,0,1,4,900000
429,ajah,blenco sangotedo ajah lagos,7,4,3,4,0,0,0,1,5,1200000
430,ajah," salvation estate, owode, ajah ado ajah lagos",4,2,2,2,1,1,0,1,4,800000
431,ajah,salvation estate scheme 2 ado ajah lagos,7,4,3,4,0,0,0,1,5,1200000
432,ajah," lekki palm city estate, opposite ecobank ado road ajah lagos ado ajah lagos",5,3,2,3,1,1,1,1,4,1400000
433,ajah,cooperative villa badore ajah badore ajah lagos,5,3,2,3,0,0,0,1,4,900000
434,ajah,new road awoyaya ajah lagos,4,2,2,2,1,1,0,1,4,800000
435,ajah,new road awoyaya ajah lagos,6,3,3,3,0,0,0,1,4,900000
436,ajah,divine estate okun ajah okun ajah ajah lagos,4,2,2,2,1,1,0,1,4,850000
437,ajah,greenville estate badore ajah lagos,4,2,2,2,1,1,0,1,4,800000
438,ajah," madam theresa avenue, maryland estate badore ajah lagos",6,3,3,3,0,0,0,1,4,900000
439,ajah," ogunfayo,awoyaya (immediately after mayfair garden estate, awoyaya) awoyaya ajah lagos",4,2,2,2,1,1,0,1,4,800000
440,ajah," ogunfayo,awoyaya (immediately after mayfair garden estate, awoyaya) awoyaya ajah lagos",2,1,1,1,0,0,0,1,1,400000
441,ajah,abraham adesanya estate ajah lagos,2,1,1,1,1,0,0,1,1,450000
442,ajah,sangotedo ajah lagos,2,1,1,1,1,1,1,1,1,500000
443,ajah," awoyaya, ajah lagos",2,1,1,1,0,0,0,1,1,400000
444,ajah,ogadan ajah lagos,5,3,2,3,1,1,0,1,4,1000000
445,ajah," majek town, sangotedo ajah lagos",5,3,2,3,0,0,0,1,4,900000
446,ajah,alashela ogombo ajah lagos,5,3,2,3,0,0,0,1,4,900000
447,ajah,liberty bells schools badore ajah lagos,7,4,3,4,0,0,0,1,5,1200000
448,ajah," by total filling station, abraham adesanya ajiwe ajah lagos",10,5,5,5,1,1,0,1,8,3000000
449,ajah,adeba road lakowe ajah lagos,3,2,1,2,1,1,0,1,4,800000
450,ajah,liberty bells school badore ajah lagos,7,4,3,4,0,0,0,1,5,1200000
451,ajah,cooperative estate badore ajah lagos,8,4,4,4,0,0,0,1,5,1200000
452,ajah,"15 isah omale street, glorious estate badore ajah lagos",5,3,2,3,0,0,0,1,4,900000
453,ajah,adenike olotu street ilaje ajah lagos,10,5,5,5,1,1,0,1,8,3000000
454,ajah,greenville estate badore addo road ajah lagos badore ajah lagos,5,3,2,3,0,0,0,1,4,900000
455,ajah," silverland estate, sangotedo ajah lagos",2,1,1,1,0,0,0,1,1,400000
456,ajah,adeniki olotu street ilajie ajah ilaje ajah lagos,10,5,5,5,1,1,0,1,8,3000000
457,ajah,seaside estate badore ajah lagos,2,1,1,1,0,0,0,1,1,400000
458,ajah,"20 ganiyu ikotun street, marshy hill estate ajah okun ajah ajah lagos",4,2,2,2,1,1,0,1,4,800000
459,ajah,okera-nla lekki ajah lagos ado ajah lagos,2,1,1,1,0,0,0,1,1,400000
460,ajah,- graceland estate ajah lagos,2,1,1,1,1,0,0,1,1,450000
461,ajah,olokonla olokonla ajah lagos,7,4,3,4,1,1,1,1,5,1500000
462,ajah,first unity estate cooperative villa badore addo badore ajah lagos,6,3,3,3,0,0,0,1,4,900000
463,ajah,ado road ado ajah lagos,2,1,1,1,1,1,1,1,1,500000
464,ajah,prince leye close ado ajah lagos,4,2,2,2,1,1,0,1,4,800000
465,ajah,sangotedo sangotedo ajah lagos,11,6,5,6,1,1,0,1,9,4000000
466,ajah,sangotedo sangotedo ajah lagos,9,5,4,5,1,1,0,1,8,3000000
467,ajah,mobil road ilaje ajah lagos,5,3,2,3,1,1,0,1,4,1000000
468,ajah," penisula garden estate, few houses away from police post peninsula estate ajah lagos",10,5,5,5,1,1,0,1,8,3000000
469,ajah,sangotedo sangotedo ajah lagos,7,4,3,4,0,0,0,1,5,1200000
470,ajah," agungi, ajah lagos",2,1,1,1,1,1,1,1,1,1000000
471,ajah,peninsula gardens estate sangotedo ajah lagos,6,3,3,3,1,1,1,1,4,2000000
472,ajah,awoyaya ajah lagos,8,4,4,4,1,1,1,1,5,2000000
473,ajah,divine homesl thomas estate ajah lagos,10,5,5,5,1,1,0,1,8,3000000
474,ajah,keji olajide street majek sangotedo ajah lagos,7,4,3,4,0,0,0,1,5,1200000
475,ajah," keji olajide street, majek sangotedo ajah lagos",5,3,2,3,0,0,0,1,4,900000
476,ajah,23 james wood street ajah lagos,6,3,3,3,1,1,1,1,4,2300000
477,ajah,ajah lekki gardens estate ajah lagos,10,5,5,5,1,1,1,1,8,5000000
478,ajah," abijo gra, ajah lagos abijo ajah lagos",15,8,7,8,1,1,0,1,10,5500000
479,ajah,university view estate opposite lagos business school off lekki epe expressway ajah lagos,2,1,1,1,1,1,1,1,1,500000
480,lekki,.... ikate lekki lagos,7,4,3,4,0,0,0,1,7,2500000
481,lekki,lekki phase 1 lekki lagos,7,4,3,4,1,1,1,1,7,3500000
482,lekki,ologolo lekki lagos,7,4,3,4,0,0,0,1,7,2500000
483,lekki,lekki phase 1 lekki lagos,9,5,4,5,1,1,1,1,9,5500000
484,lekki,ikate elegushi lekki ikate lekki lagos,9,5,4,5,1,0,0,1,9,4000000
485,lekki,lekki phase 1 lekki lagos,7,4,3,4,1,1,1,1,7,4300000
486,lekki,osapa london lekki lagos,7,4,3,4,0,0,0,0,7,2300000
487,lekki,ikota lekki lagos,9,5,4,5,0,0,0,1,9,3500000
488,lekki,ikate lekki lagos,7,4,3,4,0,0,0,0,7,2000000
489,lekki,lekki phase 1 lekki lagos,7,4,3,4,1,1,1,1,7,4000000
490,lekki,lekki phase 1 lekki lagos,7,4,3,4,0,0,0,1,7,2500000
491,lekki,ikota lekki lagos,5,3,2,3,0,0,0,0,7,1600000
492,lekki,ikota villa estate lekki phase 2 lekki lagos,11,6,5,6,0,0,0,0,10,4700000
493,lekki,lekki phase 1 lekki lagos,8,4,4,4,0,0,0,1,7,2800000
494,lekki,kajola estate ibeju lekki lagos,7,4,3,4,0,0,0,0,7,2000000
495,lekki,lekki phase 1 lekki lagos,7,4,3,4,1,1,1,1,7,4300000
496,lekki,lekki phase 1 lekki lagos,7,4,3,4,1,1,1,1,7,4300000
497,lekki,osapa london lekki lagos,5,3,2,3,1,1,0,1,7,2500000
498,lekki,lekki phase 1 lekki lagos,7,4,3,4,1,1,1,1,7,3500000
499,lekki,lekki phase 1 lekki lagos,7,4,3,4,1,1,1,1,7,4300000
500,lekki,westend estate ikota lekki lagos,13,7,6,7,0,0,0,0,10,5500000
501,lekki,ikota lekki lagos,7,4,3,4,0,0,0,1,7,2600000
502,lekki,lekki phase 1 lekki lagos,11,6,5,6,0,0,0,0,10,4700000
503,lekki,lekki phase 1 lekki lagos,11,6,5,6,1,1,0,1,10,6200000
504,lekki,osapa lekki phase 1 lekki lagos,7,4,3,4,0,0,0,0,7,2300000
505,lekki,lekki phase 1 lekki lagos,5,3,2,3,0,0,0,1,7,2400000
506,lekki,"  lakowe gulf resort eatate, sixk tiger close ibeju lekki lagos",8,4,4,4,1,0,0,1,7,3000000
507,lekki,"6, abimbola owodunni close, seaside estate, off badore road, ajah, lekki, lagos. badore ajah lagos",7,4,3,4,0,0,0,0,7,2000000
508,lekki,alpha beach road igbo efon lekki lagos,7,4,3,4,0,0,0,1,7,2700000
509,lekki,igbo efon lekki lagos,7,4,3,4,0,0,0,0,7,2000000
510,lekki,oral estate lekki lagos,11,6,5,6,0,0,0,0,10,4700000
511,lekki,chevron lekki lagos,11,6,5,6,0,0,0,0,10,4700000
512,lekki,"u3 estate, akinleye street lekki phase 1 lekki lagos",9,5,4,5,1,1,1,1,9,5600000
513,lekki,lekki phase 1 lekki lagos,7,4,3,4,0,0,0,1,7,2500000
514,lekki,lekki phase 1 lekki lagos,5,3,2,3,1,1,0,1,7,2500000
515,lekki,lekki phase 1 lekki lagos,5,3,2,3,1,1,0,1,7,2500000
516,lekki,babatunde anjouse lekki phase 1 lekki lagos,9,5,4,5,1,1,1,1,9,5000000
517,lekki,chevron lekki lagos,9,5,4,5,0,0,0,1,9,3500000
518,lekki,chevron lekki lagos,9,5,4,5,1,0,0,1,9,4000000
519,lekki,osapa london lekki lagos,7,4,3,4,1,0,0,1,7,3000000
520,lekki,osapa london lekki lagos,9,5,4,5,1,0,0,1,9,4000000
521,lekki,lekki right oniru lekki lagos,3,2,1,2,1,0,0,1,6,1700000
522,lekki,ikota lekki lagos,7,4,3,4,0,0,0,0,7,2000000
523,lekki,lekki phase 1 lekki lagos,7,4,3,4,1,1,1,1,7,4300000
524,lekki,osapa london lekki lagos,9,5,4,5,1,0,0,1,9,4000000
525,lekki,osapa london lekki lagos,11,6,5,6,0,0,0,0,10,4700000
526,lekki,"  off orchid hotel road, lafiaji lekki lagos",9,5,4,5,0,0,0,1,9,3500000
527,lekki,lekki phase 1 lekki lagos,11,6,5,6,0,0,0,1,10,6000000
528,lekki,megamound estate ikota lekki lagos,9,5,4,5,0,0,0,1,9,3500000
529,lekki,ologolo lekki lagos,9,5,4,5,1,0,0,1,9,4000000
530,lekki,lekki phase 1 lekki lagos,9,5,4,5,0,0,0,1,9,3500000
531,lekki,chevron lekki lagos,9,5,4,5,0,0,0,1,9,3600000
532,lekki,lekki phase 1 lekki lagos,7,4,3,4,0,0,0,1,7,2500000
533,lekki,lekki phase 1 lekki lagos,11,6,5,6,1,1,0,1,10,6200000
534,lekki,lekki phase 1 lekki lagos,11,6,5,6,1,1,0,1,10,6200000
535,lekki,orchid lekki lagos,9,5,4,5,1,1,1,1,9,5000000
536,lekki,lekki phase 1 lekki lagos,5,3,2,3,1,1,1,1,7,2800000
537,lekki,lekki phase 1 lekki lagos,7,4,3,4,1,1,1,1,7,3500000
538,lekki,lekki phase 1 lekki lagos,7,4,3,4,0,0,0,1,7,2700000
539,lekki,lekki phase 1 lekki lagos,7,4,3,4,1,1,1,1,7,3500000
540,lekki,lekki phase 1 lekki lagos,9,5,4,5,1,1,1,1,9,5600000
541,lekki,lekki phase 1 lekki lagos,7,4,3,4,0,0,0,1,7,2500000
542,lekki,lekki phase 1 lekki lagos,11,6,5,6,0,0,0,1,10,6000000
543,lekki,off orchid road lekki lagos,11,6,5,6,0,0,0,0,10,4700000
544,lekki,lekki phase 1 lekki lagos,12,6,6,6,1,1,0,1,10,6200000
545,lekki,lekki phase 1 lekki lagos,7,4,3,4,0,0,0,1,7,2500000
546,lekki,lekki phase 1 lekki lagos,11,6,5,6,1,1,0,1,10,6200000
547,lekki,chevron lekki lagos,7,4,3,4,0,0,0,0,7,2000000
548,lekki,agungi lekki phase 2 lekki lagos,2,1,1,1,0,0,0,1,4,800000
549,lekki,lekki phase 1 lekki lagos,7,4,3,4,0,0,0,1,7,2500000
550,lekki,lekki lagos,2,1,1,1,0,0,0,0,4,650000
551,lekki,lekki phase 1 lekki lagos,9,5,4,5,1,1,1,1,9,5000000
552,lekki,bera estate chevron lekki lagos,9,5,4,5,0,0,0,1,9,3500000
553,lekki,lekki phase 1 lekki lagos,11,6,5,6,0,0,0,1,10,6000000
554,lekki,lekki phase 1 lekki lagos,8,5,3,5,0,0,0,1,9,3500000
555,lekki,lekki phase 1 lekki lagos,11,6,5,6,1,1,0,1,10,6200000
556,lekki,lekki phase 1 lekki lagos,11,6,5,6,0,0,0,1,10,5500000
557,lekki,... lekki phase 1 lekki lagos,9,5,4,5,1,1,1,1,9,5600000
558,lekki,lekki phase 1 lekki lagos,9,5,4,5,1,1,1,1,9,5000000
559,lekki,chevron lekki lagos,9,5,4,5,0,0,0,1,9,3500000
560,lekki,lekki phase 1 lekki lagos,11,6,5,6,0,0,0,0,10,5000000
561,lekki,lekki phase 1 lekki lagos,9,5,4,5,1,0,0,1,9,4000000
562,lekki,lafiaji lekki lagos,7,4,3,4,0,0,0,0,7,2300000
563,lekki,... osapa london lekki lagos,9,5,4,5,0,0,0,1,9,3500000
564,lekki,lafiaji community lekki lagos,4,2,2,2,0,0,0,0,6,900000
565,lekki,lekki phase 1 lekki lagos,7,4,3,4,1,1,1,1,7,4300000
566,lekki,- lekki phase 1 lekki lagos,5,3,2,3,1,1,1,1,7,3000000
567,lekki,ikate lekki lagos,7,4,3,4,0,0,0,1,7,2500000
568,lekki,chevron lekki lagos,9,5,4,5,1,0,1,1,9,4500000
569,lekki,lekki lekki lagos,2,1,1,1,1,1,1,1,4,1700000
570,lekki,osapa london lekki lagos,9,5,4,5,1,0,0,1,9,4000000
571,lekki,ikota lekki lagos,11,6,5,6,1,1,0,1,10,6200000
572,lekki,chevron lekki lagos,9,5,4,5,0,0,0,1,9,3500000
573,lekki,osapa london lekki lagos,7,4,3,4,0,0,0,1,7,2500000
574,lekki,lekki phase 1 lekki lagos,7,4,3,4,1,0,0,1,7,3000000
575,lekki,ikate lekki lagos,11,6,5,6,0,0,0,1,10,6000000
576,lekki,lekki phase 1 lekki lagos,5,3,2,3,0,0,0,1,7,2000000
577,lekki,.. lekki phase 1 lekki lagos,11,6,5,6,1,1,0,1,10,6200000
578,lekki,lekki phase 1 lekki lagos,9,5,4,5,1,1,1,1,9,5000000
579,lekki,westend estate ikota lekki lagos,7,4,3,4,0,0,0,0,7,2000000
580,lekki,ikate lekki lagos,5,3,2,3,0,0,0,1,7,2000000
581,lekki,lekki palm city ajah lagos,11,6,5,6,0,0,0,0,10,4700000
582,lekki,lekki phase 1 lekki lagos,11,6,5,6,0,0,0,0,10,5000000
583,lekki,lekki phase 1 lekki lagos,2,1,1,1,1,1,1,1,4,1800000
584,lekki,"  buena vista estate, lekki lekki lagos",9,5,4,5,0,0,0,1,9,3500000
585,lekki,osapa london lekki lagos,9,5,4,5,0,0,0,1,9,3500000
586,lekki,lekki phase 1 lekki lagos,9,5,4,5,1,0,1,1,9,4500000
587,lekki,.. lekki phase 1 lekki lagos,11,6,5,6,1,1,0,1,10,6200000
588,lekki,agungi lekki lagos,7,4,3,4,1,0,0,1,7,3000000
589,lekki,lekki phase 1 lekki lagos,9,5,4,5,1,0,0,1,9,4000000
590,lekki,dreamworld africana way lekki phase 2 lekki lagos,11,6,5,6,0,0,0,0,10,4700000
591,lekki,jakande lekki lagos,11,6,5,6,1,1,0,1,10,6200000
592,lekki,ikota lekki lagos,5,3,2,3,0,0,0,0,7,1600000
593,lekki,chevron lekki lagos,9,5,4,5,1,0,1,1,9,4500000
594,lekki,nicon town lekki lagos,9,5,4,5,1,1,1,1,9,5600000
595,lekki,lekki phase 1 lekki lagos,9,5,4,5,1,1,1,1,9,5000000
596,lekki,lekki phase 1 lekki lagos,11,6,5,6,0,0,0,1,10,6000000
597,lekki,chevron lekki lagos,5,3,2,3,0,0,0,1,7,2000000
598,lekki,ikate lekki lagos,11,6,5,6,0,0,0,0,10,5000000
599,lekki,off oladimeji alo lekki phase 1 lekki lagos,7,4,3,4,1,1,1,1,7,4300000
600,lekki,agungi lekki lagos,9,5,4,5,0,0,0,1,9,3500000
601,lekki,off admiralty road lekki. lekki phase 1 lekki lagos,7,4,3,4,1,1,1,1,7,4300000
602,lekki,lekki phase 1 lekki lagos,7,4,3,4,1,1,1,1,7,3500000
603,lekki,ologolo lekki lagos,9,5,4,5,0,0,0,1,9,3500000
604,lekki,orchid lekki phase 2 lekki lagos,9,5,4,5,1,0,1,1,9,4500000
605,lekki,providence lekki phase 1 lekki lagos,4,2,2,2,1,1,1,1,6,2800000
606,lekki,hakkem dickson lekki phase 1 lekki lagos,7,4,3,4,1,1,1,1,7,3500000
607,lekki,ikate ikate lekki lagos,9,5,4,5,1,1,1,1,9,5000000
608,lekki,lekki phase 1 lekki lagos,9,5,4,5,1,1,1,1,9,5600000
609,lekki,off omorihnre johnson lekki phase 1 lekki lagos,7,4,3,4,0,0,0,1,7,2800000
610,lekki,zone b nicon town nicon town lekki lagos,11,6,5,6,1,1,0,1,10,6200000
611,lekki,idado lekki lagos,7,4,3,4,1,1,1,1,7,4300000
612,lekki,lekki phase 1 lekki lagos,3,2,1,2,1,0,0,1,6,1800000
613,lekki,idado lekki lagos,9,5,4,5,1,0,1,1,9,4500000
614,lekki,osapa lekki lagos,9,5,4,5,0,0,0,1,9,3500000
615,lekki,lekki county homes ikota lekki lagos,11,6,5,6,1,1,0,1,10,6200000
616,lekki,"  immediately after shoprite, sangotedo, lekki, lagos crown estate ajah lagos",9,5,4,5,0,0,0,1,9,3500000
617,lekki,off rahman adeboyejo lekki phase 1 lekki lagos,11,6,5,6,1,1,0,1,10,6200000
618,lekki,chevron lekki lagos,9,5,4,5,1,0,1,1,9,4500000
619,lekki,ologolo lekki lagos,9,5,4,5,0,0,0,1,9,3500000
620,lekki,lekki phase 1 lekki lagos,15,8,7,8,1,1,0,1,10,7000000
621,lekki,agungi lekki lagos,9,5,4,5,0,0,0,1,9,3500000
622,lekki,oral estate lekki lagos,9,5,4,5,0,0,0,1,9,3500000
623,lekki,idado lekki lagos,5,3,2,3,1,1,0,1,7,2500000
624,lekki,lekki county home lekki phase 2 lekki lagos,9,5,4,5,0,0,0,1,9,3500000
625,lekki,"  within cooplag estate, along orchid hotel road chevron lekki lagos",11,6,5,6,0,0,0,0,10,4700000
626,lekki,safecourt apartments next to spar ikate lekki lagos,7,4,3,4,1,0,0,1,7,3000000
627,lekki,lekki phase 1 lekki lagos,11,6,5,6,1,1,0,1,10,6200000
628,lekki,chevron lekki lagos,9,5,4,5,0,0,0,1,9,3500000
629,lekki,"off dsc street ,lekki right. lekki phase 1 lekki lagos",5,3,2,3,1,1,1,1,7,3000000
630,lekki,"off dsc, lekki right. lekki phase 1 lekki lagos",5,3,2,3,1,1,0,1,7,2500000
631,lekki,lekki phase 1 lekki lagos,7,4,3,4,1,1,1,1,7,3500000
632,lekki,osapa london lekki lagos,9,5,4,5,0,0,0,1,9,3700000
633,lekki,ikate lekki lagos,11,6,5,6,0,0,0,1,10,6000000
634,lekki,ikate lekki lagos,11,6,5,6,0,0,0,0,10,4700000
635,lekki,off white sand school road. lekki phase 1 lekki lagos,7,4,3,4,0,0,0,1,7,2800000
636,lekki,lekki phase 1 lekki lagos,9,5,4,5,1,0,0,1,9,4000000
637,lekki,lekki phase 1 lekki lagos,5,3,2,3,1,1,1,1,7,3000000
638,lekki,lafiaji lekki lagos,9,5,4,5,0,0,0,1,9,3500000
639,lekki,- lekki phase 1 lekki lagos,9,5,4,5,1,1,1,1,9,5500000
640,lekki,"lekki phase 1, lekki lekki phase 1 lekki lagos",6,3,3,3,1,1,1,1,7,3500000
641,lekki,chevron alternative road chevron lekki lagos state nigeria chevron lekki lagos,8,4,4,4,1,0,0,1,7,3000000
642,lekki,professor kumi st lekki phase 1 lekki lagos,8,4,4,4,1,1,1,1,7,4300000
643,lekki,chevron lekki lagos,11,6,5,6,0,0,0,1,10,5500000
644,lekki,off admiralty way lekki phase 1 lekki lagos,5,3,2,3,1,1,0,1,7,2500000
645,lekki,lekki right ikate lekki lagos,7,4,3,4,1,1,1,1,7,3500000
646,lekki,"  safe court estate, ikate lekki lagos",7,4,3,4,1,0,0,1,7,3000000
647,lekki,agungi agungi lekki lagos,7,4,3,4,0,0,0,1,7,2500000
648,lekki,eletu osapa london lekki lagos,11,6,5,6,0,0,0,0,10,4700000
649,lekki,ilasan ilasan lekki lagos,5,3,2,3,0,0,0,0,7,1700000
650,lekki,safe court estate ikate lekki lagos,7,4,3,4,1,0,0,1,7,3000000
651,lekki,lekki paradise chevron lekki lagos,7,4,3,4,1,1,1,1,7,3500000
652,lekki,close to shoprite jakande lekki lagos,9,5,4,5,1,0,0,1,9,4000000
653,lekki,lekki phase 2 lekki lagos,7,4,3,4,0,0,0,0,7,2300000
654,lekki,lekki phase 1 lekki phase 1 lekki lagos,11,6,5,6,1,1,0,1,10,6200000
655,lekki,orchid road chevron lekki lagos,7,4,3,4,0,0,0,1,7,2500000
656,lekki,ikate lekki lagos,5,3,2,3,0,0,0,1,7,2300000
657,lekki,off admiralty way lekki phase 1 lekki lagos,11,6,5,6,1,1,0,1,10,6200000
658,lekki,eletu osapa london lekki lagos,7,4,3,4,0,0,0,1,7,2500000
659,lekki,ikota villa ikota lekki lagos,7,4,3,4,0,0,0,0,7,2000000
660,lekki,"  pinnock beach estate, osapa london lekki lagos",9,5,4,5,1,0,1,1,9,4500000
661,lekki,idado idado lekki lagos,7,4,3,4,0,0,0,0,7,2000000
662,lekki,"  eletu street, jakande jakande lekki lagos",3,2,1,2,0,0,0,1,6,1500000
663,lekki,chevron lekki lagos,9,5,4,5,1,0,1,1,9,4500000
664,lekki,admiralty home estate igbo efon lekki lagos,9,5,4,5,0,0,0,1,9,3500000
665,lekki,allan allan balogun street osapa london lekki lagos,8,4,4,4,1,0,0,1,7,3000000
666,lekki,lekki county ikota lekki lagos,2,1,1,1,0,0,0,0,4,650000
667,lekki,orchid road victoria crest estate ikota lekki lagos,10,5,5,5,0,0,0,1,9,3500000
668,lekki,orchid chevron lekki lagos,9,5,4,5,0,0,0,1,9,3500000
669,lekki,off admiralty way lekki phase 1 lekki lagos,7,4,3,4,1,1,1,1,7,4300000
670,lekki,off admiralty way lekki phase 1 lekki lagos,7,4,3,4,0,0,0,1,7,2500000
671,lekki,. lekki phase 1 lekki lagos,10,5,5,5,0,0,0,1,9,3500000
672,lekki,off admiralty way lekki phase 1 lekki lagos,4,2,2,2,0,0,0,0,6,1000000
673,lekki,"  abijo gra, lekki, lagos abijo ajah lagos",14,6,8,6,0,0,0,0,10,4700000
674,lekki,igbo efon lekki lagos,7,4,3,4,0,0,0,0,7,2000000
675,lekki,chisco road ikate lekki lagos,7,4,3,4,0,0,0,0,7,2300000
676,lekki,lekki lekki phase 1 lekki lagos,7,4,3,4,1,1,1,1,7,4300000
677,lekki,lekki right lekki phase 1 lekki lagos,11,6,5,6,0,0,0,1,10,6000000
678,lekki,chevron lekki lagos,11,6,5,6,0,0,0,0,10,4700000
679,lekki,ologolo ologolo lekki lagos,9,5,4,5,0,0,0,1,9,3500000
680,lekki,agungi agungi lekki lagos,7,4,3,4,0,0,0,1,7,2500000
681,lekki,"  eleganza bus stop, orchid road. ikota lekki lagos",7,4,3,4,0,0,0,1,7,2500000
682,lekki,ikate lekki lagos,2,1,1,1,0,0,0,0,4,700000
683,lekki,lekki phase 1 lekki lagos,9,5,4,5,1,0,1,1,9,4500000
684,lekki,off admiralty way lekki phase 1 lekki lagos,5,3,2,3,0,0,0,1,7,2000000
685,lekki,- chevron lekki lagos,8,4,4,4,1,1,1,1,7,4000000
686,lekki,oral estate lekki phase 2 lekki lagos,5,3,2,3,0,0,0,0,7,1600000
687,lekki,oral estate oral estate lekki lagos,3,2,1,2,0,0,0,1,6,1500000
688,lekki,chevron lekki lagos,2,1,1,1,0,0,0,0,4,650000
689,lekki,chevron lekki lagos,11,6,5,6,0,0,0,0,10,4700000
690,lekki,... ikate lekki lagos,9,5,4,5,0,0,0,1,9,3500000
691,lekki,chevron lekki lagos,9,5,4,5,0,0,0,1,9,3500000
692,lekki,ikate lekki lagos,5,3,2,3,1,1,0,1,7,2500000
693,lekki,orchid road lekki phase 2 lekki lagos,5,3,2,3,1,1,0,1,7,2500000
694,lekki,lekki phase 1 lekki phase 1 lekki lagos,7,4,3,4,0,0,0,1,7,2500000
695,lekki,ikate-lekki ikate lekki lagos,9,6,3,6,1,1,0,1,10,6200000
696,lekki,off admiralty way lekki phase 1 lekki lagos,5,3,2,3,0,0,0,1,7,2000000
697,lekki,"  bourdillon court, chevron drive chevron lekki lagos",9,5,4,5,1,0,0,1,9,4000000
698,lekki,"  cadogan estate, osapa london lekki lagos",7,4,3,4,1,1,1,1,7,3800000
699,lekki,eletu osapa london lekki lagos,7,4,3,4,0,0,0,0,7,2000000
700,lekki,lekki lekki phase 1 lekki lagos,5,3,2,3,1,1,1,1,7,3500000
701,lekki,ilasan ilasan lekki lagos,7,4,3,4,0,0,0,0,7,2000000
702,lekki,ikate lekki lagos,2,1,1,1,0,0,0,0,4,650000
703,lekki,lekki paradise chevron lekki lagos,9,5,4,5,0,0,0,1,9,3500000
704,lekki,muritala eletu osapa london lekki lagos,7,4,3,4,0,0,0,0,7,2000000
705,lekki,ikate lekki lagos,10,5,5,5,1,1,1,1,9,5600000
706,lekki,eletu osapa london lekki lagos,5,3,2,3,0,0,0,1,7,2000000
707,lekki,whitesands street lekki phase 1 lekki lagos,9,5,4,5,1,1,1,1,9,5500000
708,lekki,lekki phase 1 lekki lagos,2,1,1,1,0,0,0,1,4,1000000
709,lekki,"  occen bay estate off ,ochid road ikota ikota lekki lagos",5,3,2,3,0,0,0,1,7,2000000
710,lekki,agungi lekki lagos,7,4,3,4,0,0,0,0,7,2000000
711,lekki,"  eleganza gardens, vgc lekki lagos",5,3,2,3,0,0,0,0,7,1400000
712,lekki,ikota villa estate ikota lekki lagos,5,3,2,3,0,0,0,0,7,1500000
713,lekki,vgc vgc lekki lagos,9,5,4,5,0,0,0,1,9,3500000
714,lekki,osapa london lekki lagos,11,6,5,6,0,0,0,0,10,4700000
715,lekki,lekki phase 2 lekki lagos,5,3,2,3,0,0,0,0,7,1600000
716,lekki,chevy view chevron lekki lagos,2,1,1,1,0,0,0,0,4,400000
717,lekki,chevron lekki lagos,9,5,4,5,0,0,0,1,9,3500000
718,lekki,"  ikota villa estate, megamound ikota lekki lagos",8,4,4,4,0,0,0,1,7,2500000
719,lekki,lekki paradise chevron lekki lagos,9,5,4,5,1,1,1,1,9,5000000
720,lekki,ikota gra ikota lekki lagos,7,4,3,4,0,0,0,0,7,2000000
721,lekki,off admiralty way lekki phase 1 lekki lagos,5,3,2,3,1,1,1,1,7,2800000
722,lekki,"5street estate,agungi agungi lekki lagos",8,4,4,4,1,0,0,1,7,3000000
723,lekki,off admiralty way lekki phase 1 lekki lagos,4,2,2,2,1,1,1,1,6,2200000
724,lekki,off admiralty way lekki phase 1 lekki lagos,7,4,3,4,0,0,0,1,7,2500000
725,lekki,close to prime water estate ikate lekki lagos,7,4,3,4,0,0,0,1,7,2500000
726,lekki,pinnock beach estate osapa london lekki lagos,7,4,3,4,0,0,0,0,7,2000000
727,lekki,bishop's court ikate lekki lagos,9,5,4,5,0,0,0,1,9,3500000
728,lekki,ikota villa estate ikota lekki lagos,9,5,4,5,0,0,0,1,9,3500000
729,lekki,"  osapa, osapa london lekki lagos",9,5,4,5,0,0,0,1,9,3500000
730,lekki,"  richmond gate estate, ikate lekki lagos",9,5,4,5,1,1,1,1,9,5000000
731,lekki,lekki lekki phase 1 lekki lagos,9,5,4,5,1,0,0,1,9,4000000
732,lekki,lekki phase 1 lekki lagos,5,3,2,3,0,0,0,0,7,1700000
733,lekki,off kusenla ikate lekki lagos,8,4,4,4,1,1,1,1,7,4300000
734,lekki,pinnock beach luxury estate osapa london lekki lagos,14,7,7,7,0,0,0,1,10,6500000
735,lekki,ikota ikota lekki lagos,5,3,2,3,0,0,0,0,7,1600000
736,lekki,oral estate oral estate lekki lagos,5,3,2,3,0,0,0,0,7,1800000
737,lekki,off admiralty way lekki phase 1 lekki lagos,9,5,4,5,1,1,1,1,9,5600000
738,lekki,eletu osapa london lekki lagos,7,4,3,4,0,0,0,0,7,2000000
739,lekki,... lekki phase 1 lekki lagos,2,1,1,1,1,1,1,1,4,1400000
740,lekki,"  pinnock beach estate, osapa london lekki lagos",11,6,5,6,1,1,0,1,10,6200000
741,lekki,lekki paradise chevron lekki lagos,7,4,3,4,0,0,0,1,7,2500000
742,lekki,chevy view chevron lekki lagos,2,1,1,1,0,0,0,0,4,400000
743,lekki,ikota villa estate ikota lekki lagos,2,1,1,1,0,0,0,0,4,500000
744,lekki,bera estate off chevron drive chevron lekki lagos,9,5,4,5,0,0,0,1,9,3500000
745,lekki,ikota lekki lagos,5,3,2,3,0,0,0,0,7,1700000
746,lekki,off admiralty way lekki phase 1 lekki lagos,9,5,4,5,1,1,1,1,9,5500000
747,lekki,orchid road oral estate lekki lagos,9,5,4,5,1,1,1,1,9,5000000
748,lekki,ilasan lekki lagos,5,3,2,3,0,0,0,0,7,1500000
749,lekki,"  chevyview estate, chevron lekki lagos",7,4,3,4,0,0,0,0,7,2000000
750,lekki,ikota lekki lagos,9,5,4,5,0,0,0,1,9,3500000
751,lekki,off admiralty way lekki phase 1 lekki lagos,3,2,1,2,0,0,0,1,6,1500000
752,lekki,"  eleganza garden, opposite vgc vgc lekki lagos",7,3,4,3,1,1,0,1,7,2500000
753,lekki,osapa london lekki lagos,5,3,2,3,1,1,0,1,7,2500000
754,lekki,"  eleganza gardens, vgc lekki lagos",3,2,1,2,0,0,0,0,6,1100000
755,lekki,"  cromwell estate, chevron lekki lagos",7,4,3,4,0,0,0,1,7,2800000
756,lekki,behind prime water gardens ikate lekki lagos,7,4,3,4,0,0,0,0,7,2200000
757,lekki,"updc estate, lekki phase 1 lekki lagos",7,4,3,4,1,1,1,1,7,4300000
758,lekki,mega chicken ikota lekki lagos,9,5,4,5,0,0,0,1,9,3500000
759,lekki,bridge gate estate agungi lekki lagos,9,5,4,5,0,0,0,1,9,3500000
760,lekki,orchid road chevron lekki lagos,9,5,4,5,0,0,0,1,9,3500000
761,lekki,idado lekki lagos,11,6,5,6,0,0,0,0,10,4700000
762,lekki,ologolo lekki lagos,5,3,2,3,0,0,0,1,7,2000000
763,lekki,lekki right side lekki phase 1 lekki lagos,7,4,3,4,1,0,0,1,7,3200000
764,lekki,pinnock beach estate osapa london lekki lagos,12,6,6,6,1,1,0,1,10,6200000
765,lekki,romay garden estate ilasan lekki lagos,9,5,4,5,0,0,0,1,9,3500000
766,lekki,megamound estate ikota lekki lagos,9,5,4,5,0,0,0,1,9,3500000
767,lekki,"  safe court apartments, ikate lekki lagos",7,4,3,4,1,1,1,1,7,3500000
768,lekki,"  bourdillon court, chevron lekki lagos",7,4,3,4,1,0,0,1,7,3000000
769,lekki,ikota lekki lagos,7,4,3,4,0,0,0,0,7,2000000
770,lekki,"tom ogboi street,off freedom way lekki phase 1 lekki phase 1 lekki lagos",7,4,3,4,1,0,0,1,7,3000000
771,lekki,off freedom way lekki phase 1 lekki phase 1 lekki lagos,11,6,5,6,0,0,0,0,10,5000000
772,lekki,lekki phase 1 lekki lagos,8,4,4,4,1,1,1,1,7,3500000
773,lekki,olofin street off admiralty road. lekki phase 1 lekki lagos,3,2,1,2,1,0,0,1,6,1700000
774,lekki,chile mba close behinde zenith bank. osapa london lekki lagos,9,5,4,5,1,0,0,1,9,4000000
775,lekki,oladimeji alo lekki phase 1 lekki lagos,2,1,1,1,1,0,0,1,4,1200000
776,lekki,ikate lekki lagos,3,2,1,2,0,0,0,1,6,1500000
777,lekki,oral estate lekki lagos,7,4,3,4,0,0,0,0,7,2000000
778,lekki,orchid road ikota lekki lagos,9,5,4,5,0,0,0,1,9,3500000
779,lekki,off freedom way lekki phase 1 lekki lagos,9,5,4,5,1,0,0,1,9,4000000
780,lekki,off admiralty road lekki phase 1 lekki phase 1 lekki lagos,5,3,2,3,0,0,0,1,7,2400000
781,lekki,oral zone 1 lekki garden ikate lekki lagos,7,4,3,4,1,0,0,1,7,3000000
782,lekki,oral estate lekki lagos,3,2,1,2,0,0,0,1,6,1500000
783,lekki,chisco off world oil fueling station. ilasan lekki lagos,7,4,3,4,0,0,0,0,7,2200000
784,lekki,off admiralty way lekki phase 1 lekki lagos,9,4,5,4,1,1,1,1,7,4300000
785,lekki,"  safecourt estate, ikate-elegushi, lagos. ikate lekki lagos",7,4,3,4,1,0,0,1,7,3000000
786,lekki,jakande lekki lagos,9,5,4,5,1,1,1,1,9,5600000
787,lekki,lekki phase 1 lekki lagos,11,6,5,6,1,1,0,1,10,6200000
788,lekki,"  chevron,lekki expressway lekki lagos",9,5,4,5,0,0,0,1,9,3500000
789,lekki,off admiralty way lekki phase 1 lekki lagos,9,5,4,5,1,0,1,1,9,4500000
790,lekki,off admiralty way lekki phase 1 lekki lagos,9,5,4,5,1,1,1,1,9,5600000
791,lekki,bosola durosinmi etti drive lekki phase 1 lekki lagos,11,6,5,6,0,0,0,1,10,6000000
792,lekki,off admiralty way lekki phase 1 lekki lagos,9,5,4,5,1,1,1,1,9,5600000
793,lekki,west ends estates ikota lekki lagos,9,5,4,5,0,0,0,1,9,3500000
794,lekki,off bisola durotimi etti lekki phase 1 lekki lagos,7,4,3,4,0,0,0,1,7,2500000
795,lekki,admiralty way lekki phase 1 lekki lagos,7,4,3,4,1,1,1,1,7,4300000
796,lekki,lekki phase 1 lekki lagos,11,6,5,6,1,1,0,1,10,6200000
797,lekki,ikota lekki lagos,11,6,5,6,0,0,0,0,10,4700000
798,lekki,cadogan estate jakande lekki lagos,7,4,3,4,1,0,0,1,7,3000000
799,lekki,lekki county homes lekki lagos,9,5,4,5,1,1,1,1,9,5600000
800,lekki,megamound estate ikota lekki lagos,9,5,4,5,0,0,0,1,9,3500000
801,lekki,ikota villa estate lekki lagos,9,5,4,5,0,0,0,1,9,3500000
802,lekki,ikate lekki lagos,13,7,6,7,0,0,0,1,10,6000000
803,lekki,lekki phase 1 lekki lagos,8,4,4,4,1,1,1,1,7,3500000
804,lekki,lekki phase 1 lekki lagos,2,1,1,1,1,1,1,1,4,1400000
805,lekki,lekki phase 1 lekki lagos,7,4,3,4,1,1,1,1,7,4300000
806,lekki,"  chevron road,lekki expressway chevron lekki lagos",9,5,4,5,0,0,0,1,9,3500000
807,lekki,off admiralty way lekki phase 1 lekki lagos,9,5,4,5,1,1,1,1,9,5600000
808,lekki,lekki phase 1 lekki lagos,11,6,5,6,1,1,0,1,10,6200000
809,lekki,off fola osibo road lekki phase 1 lekki lagos,7,4,3,4,1,0,0,1,7,3000000
810,lekki,osapa london lekki lagos,10,5,5,5,0,0,0,1,9,3500000
811,lekki,off fola osibo lekki phase 1 lekki lagos,3,2,1,2,1,1,1,1,6,3000000
812,lekki,orchid road lekki lagos,9,5,4,5,1,0,0,1,9,4000000
813,lekki,off admiralty way lekki phase 1 lekki lagos,9,5,4,5,1,1,1,1,9,5500000
814,lekki,off admirality way lekki phase 1 lekki lagos,9,5,4,5,1,1,1,1,9,5000000
815,lekki,iroko awe elegushi lekki ilasan lekki lagos,2,1,1,1,0,0,0,0,4,700000
816,lekki,orchid hotel road. lekki phase 2 lekki lagos,10,5,5,5,0,0,0,1,9,3500000
817,lekki,osapa london lekki osapa london lekki lagos,7,4,3,4,0,0,0,1,7,2500000
818,lekki,ikota villa estate by mega chicken ikota lekki lagos,7,4,3,4,0,0,0,0,7,2000000
819,lekki,lekki conservative road ikota before 2nd toll gate chevron lekki lagos,9,5,4,5,0,0,0,1,9,3500000
820,lekki,igbo efon lekki lagos,5,3,2,3,0,0,0,0,7,1500000
821,lekki,"horizon 11,by meadow hall way ikate elegushi lekki ikate lekki lagos",7,4,3,4,0,0,0,1,7,2750000
822,lekki,fairview estate orchid hotel road chevron drive lekki lekki lagos,9,5,4,5,0,0,0,1,9,3500000
823,lekki,alpha beach road new road (sea view estate) chevron lekki lagos,7,4,3,4,0,0,0,0,7,2000000
824,lekki,off admiralty way lekki phase 1 lekki lagos,5,3,2,3,1,1,1,1,7,3500000
825,lekki,van daniel road by eleganza bustop chevron lekki lagos,2,1,1,1,0,0,0,0,4,500000
826,lekki,greenville estate agungi lekki lagos,2,1,1,1,0,0,0,0,4,400000
827,lekki,rose rock estate orchid road chevron drive lekki chevron lekki lagos,9,5,4,5,0,0,0,1,9,3500000
828,lekki,close to victory park estate osapa london osapa london lekki lagos,7,4,3,4,0,0,0,1,7,2500000
829,lekki,directly on spg road opposite argungi lekki ologolo lekki lagos,7,4,3,4,0,0,0,0,7,2000000
830,lekki,chevy view estate off chevron drive chevron lekki lagos,7,4,3,4,0,0,0,0,7,2000000
831,lekki,off road 12 lekki phase one lekki phase 1 lekki lagos,3,2,1,2,0,0,0,0,6,900000
832,lekki,lekki phase 1 lekki lagos,7,4,3,4,1,0,0,1,7,3000000
833,lekki,idado lekki lagos,5,3,2,3,0,0,0,0,7,1500000
834,lekki,environment agungi lekki lagos,2,1,1,1,0,0,0,0,4,500000
835,lekki,alpha beach road chevron drive lekki chevron lekki lagos,5,3,2,3,0,0,0,0,7,1500000
836,lekki,"  alpha beach road, new road chevron drive lekki chevron lekki lagos",7,4,3,4,0,0,0,0,7,2400000
837,lekki,... osapa london lekki lagos,5,3,2,3,0,0,0,0,7,1700000
838,lekki,in an estate by second toll gate oral estate lekki lagos,6,3,3,3,0,0,0,1,7,2000000
839,lekki,buena vista estate orchid road chevron drive lekki lagos chevron lekki lagos,9,5,4,5,0,0,0,1,9,3500000
840,lekki,bogije ibeju lekki lagos,5,3,2,3,0,0,0,0,7,1000000
841,lekki,new creation street 2nd round about by pinnacle petrol station lekki phase 1 lekki lagos,3,2,1,2,0,0,0,1,6,1600000
842,lekki,esther adeleke lekki phase 1 lekki lagos,7,4,3,4,0,0,0,1,7,2600000
843,lekki,lekki phase 1 lekki lagos,9,5,4,5,0,0,0,1,9,3500000
844,lekki,around dominoes pizza agungi lekki lagos,2,1,1,1,0,0,0,1,4,1000000
845,lekki,.. lekki phase 1 lekki lagos,3,2,1,2,1,0,0,1,6,1700000
846,lekki,chevron alternative routes lekki chevron lekki lagos,8,4,4,4,0,0,0,0,7,2000000
847,lekki,in an estate osapa london osapa london lekki lagos,7,4,3,4,1,0,0,1,7,3000000
848,lekki,grand view estate argungi lekki agungi lekki lagos,9,5,4,5,0,0,0,1,9,3500000
849,lekki,u3 estate by petrocam filling station lekki right lekki phase 1 lekki lagos,5,3,2,3,0,0,0,1,7,2300000
850,lekki,by marwa bustop (just immediately after lekki phase 1) lekki phase 1 lekki lagos,2,1,1,1,0,0,0,0,4,400000
851,lekki,safecourts estate ikate ikate lekki lagos,8,5,3,5,0,0,0,1,9,3500000
852,lekki,the address home jakande lekki jakande lekki lagos,9,5,4,5,1,1,1,1,9,5500000
853,lekki,prime water garden ikate lekki lagos,7,4,3,4,1,1,1,1,7,3500000
854,lekki,by abraham adesanya estate lekki gardens estate ajah lagos,7,4,3,4,0,0,0,0,7,2000000
855,lekki,close to domino pizza agungi lekki lagos,3,2,1,2,0,0,0,0,6,900000
856,lekki,igbo efon lekki igbo efon lekki lagos,3,2,1,2,0,0,0,0,6,1000000
857,lekki,off durosinmi etti lekki phase 1 lekki lagos,11,6,5,6,0,0,0,0,10,4700000
858,lekki,prime water view estate 2 ikate elegushi lekki lagos ikate lekki lagos,9,5,4,5,1,1,1,1,9,5000000
859,lekki,yeye olofin lekki phase one lekki phase 1 lekki lagos,3,2,1,2,0,0,0,1,6,1500000
860,lekki,off freedom way lekki phase one lagos lekki phase 1 lekki lagos,3,2,1,2,0,0,0,0,6,1400000
861,lekki,off tf kuboye street lekki phase one lekki phase 1 lekki lagos,7,4,3,4,1,0,0,1,7,3000000
862,lekki,amen estate eleko ibeju lekki eleko ibeju lekki lagos,3,2,1,2,0,0,0,0,6,900000
863,lekki,amen estate eleko ibeju lekki lagos,9,5,4,5,1,0,1,1,9,4500000
864,lekki,ilasan lekki lagos,9,5,4,5,0,0,0,1,9,3500000
865,lekki,chevron lekki lagos,11,6,5,6,0,0,0,0,10,4700000
866,lekki,chevron lekki lagos,9,5,4,5,0,0,0,1,9,3500000
867,lekki,lekki phase 1 lekki lagos,9,5,4,5,1,1,1,1,9,5000000
868,lekki,lekki phase 1 lekki lagos,11,6,5,6,1,1,0,1,10,6200000
869,lekki,osapa london lekki lagos,5,3,2,3,0,0,0,0,7,1700000
870,lekki,ikate lekki lagos,9,5,4,5,0,0,0,1,9,3500000
871,lekki,agungi lekki lagos,9,5,4,5,0,0,0,1,9,3500000
872,lekki,ologolo lekki lagos,3,2,1,2,0,0,0,1,6,1500000
873,lekki,ikota villa estate ikota lekki lagos,9,5,4,5,0,0,0,1,9,3500000
874,lekki,jakande lekki lagos,7,4,3,4,0,0,0,1,7,2800000
875,lekki,lekki phase 1 lekki lagos,9,5,4,5,1,1,1,1,9,5600000
876,lekki,lekki phase 1 lekki lagos,7,4,3,4,1,0,0,1,7,3000000
877,lekki,ikota lekki lagos,7,4,3,4,0,0,0,0,7,2000000
878,lekki,lekki phase 1 lekki lagos,11,6,5,6,1,1,0,1,10,6200000
879,lekki,lekki phase 1 lekki lagos,9,5,4,5,1,1,1,1,9,5000000
880,lekki,agungi lekki lagos,9,5,4,5,0,0,0,1,9,3500000
881,lekki,osapa london lekki lagos,7,4,3,4,0,0,0,0,7,2000000
882,lekki,idado lekki lagos,11,6,5,6,0,0,0,0,10,4700000
883,lekki,ikate lekki lagos,5,3,2,3,0,0,0,1,7,2000000
884,lekki,ikota lekki lagos,9,5,4,5,0,0,0,1,9,3500000
885,lekki,ikate lekki lagos,5,3,2,3,1,1,0,1,7,2500000
886,lekki,chevron lekki lagos,7,4,3,4,1,0,0,1,7,3000000
887,lekki,lekki phase 1 lekki lagos,3,2,1,2,0,0,0,0,6,900000
888,lekki,idado lekki lagos,7,4,3,4,0,0,0,0,7,2000000
889,lekki,agungi lekki lagos,7,4,3,4,0,0,0,0,7,2000000
890,lekki,lekki phase 1 lekki lagos,7,4,3,4,0,0,0,1,7,2700000
891,lekki,lekki phase 1 lekki lagos,10,5,5,5,1,1,1,1,9,5000000
892,lekki,ikate lekki lagos,9,5,4,5,0,0,0,1,9,3500000
893,lekki,lekki phase 1 lekki lagos,7,4,3,4,0,0,0,0,7,2000000
894,lekki,lekki phase 1 lekki lagos,9,5,4,5,1,1,1,1,9,5600000
895,lekki,ikota lekki lagos,9,5,4,5,0,0,0,1,9,3500000
896,lekki,lafiaji lekki lagos,7,4,3,4,0,0,0,1,7,2500000
897,lekki,ikate lekki lagos,5,3,2,3,0,0,0,1,7,2000000
898,lekki,jakande lekki lagos,9,5,4,5,0,0,0,1,9,3500000
899,lekki,ikota lekki lagos,7,4,3,4,0,0,0,0,7,2000000
900,lekki,osapa london lekki lagos,8,4,4,4,1,0,0,1,7,3000000
901,lekki,ikate lekki lagos,11,6,5,6,0,0,0,1,10,6000000
902,lekki,lafiaji lekki lagos,5,3,2,3,0,0,0,0,7,1800000
903,lekki,ikate lekki lagos,9,5,4,5,0,0,0,1,9,3500000
904,lekki,idado lekki lagos,7,4,3,4,0,0,0,0,7,2000000
905,lekki,ologolo lekki lagos,7,4,3,4,0,0,0,0,7,2000000
906,lekki,bera estate chevron lekki lagos,9,5,4,5,0,0,0,1,9,3500000
907,lekki,lekki phase 1 lekki lagos,3,2,1,2,0,0,0,0,6,1300000
908,lekki,lekki phase 1 lekki lagos,3,2,1,2,1,0,0,1,6,1800000
909,lekki,eru-ifa ikate lekki lagos,7,4,3,4,1,0,0,1,7,3000000
910,lekki,lekki phase 1 lekki lagos,11,6,5,6,0,0,0,1,10,6000000
911,lekki,orchid lafiaji lekki lekki lagos,9,5,4,5,0,0,0,1,9,3500000
912,lekki,igbo efon lekki lagos,7,4,3,4,0,0,0,0,7,2000000
913,lekki,lekki phase 1 lekki lagos,3,2,1,2,0,0,0,1,6,1500000
914,lekki,lekki lekki phase 1 lekki lagos,8,4,4,4,1,1,1,1,7,3500000
915,lekki,"lekki phase 1,right lekki phase 1 lekki lagos",9,5,4,5,1,1,1,1,9,5500000
916,lekki,lafiaji lekki lagos,9,5,4,5,0,0,0,1,9,3500000
917,lekki,chevy view estate lekki chevron lekki lagos,9,5,4,5,0,0,0,1,9,3500000
918,lekki,lekki county homes lekki abule egba lagos,7,4,3,4,1,1,1,1,7,4300000
919,lekki,chevron lekki chevron lekki lagos,9,5,4,5,0,0,0,1,9,3500000
920,lekki,off durosimi etti street lekki phase 1 lekki lagos,7,4,3,4,1,1,1,1,7,3500000
921,lekki,ologolo lekki lagos,5,3,2,3,0,0,0,0,7,1300000
922,lekki,chevron chevron lekki lagos,7,4,3,4,0,0,0,0,7,2000000
923,lekki,lekki phase 1 lekki lagos,7,4,3,4,1,1,1,1,7,3700000
924,lekki,ajiran rd agungi lekki lagos,2,1,1,1,0,0,0,1,4,1000000
925,lekki,orchid lekki phase 2 lekki lagos,9,5,4,5,1,0,1,1,9,4500000
926,lekki,off victoria arubieke. lekki phase 1 lekki lagos,2,1,1,1,1,1,1,1,4,1700000
927,lekki,fatai arubieke street lekki phase 1 lekki lagos,7,4,3,4,1,1,1,1,7,4000000
928,lekki,lekki phase 1 lekki lagos,9,5,4,5,1,1,1,1,9,5000000
929,lekki,idado lekki lagos,7,4,3,4,0,0,0,0,7,2000000
930,lekki,lekki phase 1 lekki lagos,11,6,5,6,0,0,0,1,10,5500000
931,lekki,lekki phase 1 lekki lagos,5,3,2,3,1,1,0,1,7,2500000
932,lekki,grace anjounse lekki phase 1 lekki lagos,5,3,2,3,1,1,1,1,7,3000000
933,lekki,agungi lekki agungi lekki lagos,9,5,4,5,0,0,0,1,9,3500000
934,lekki,chief collins lekki phase 1 lekki lagos,5,3,2,3,1,1,0,1,7,2500000
935,lekki,orchid road oral estate lekki lagos,5,3,2,3,0,0,0,0,7,1800000
936,lekki,lekki phase 1 lekki lagos,11,6,5,6,0,0,0,1,10,6000000
937,lekki,off admiralty road lekki phase 1 lekki lagos,9,5,4,5,1,1,1,1,9,5000000
938,lekki,off admiralty road lekki phase 1 lekki lagos,7,4,3,4,0,0,0,1,7,2700000
939,lekki,phase 1 lekki phase 1 lekki lagos,7,4,3,4,1,1,1,1,7,3500000
940,lekki,lekki right lekki phase 1 lekki lagos,7,4,3,4,0,0,0,1,7,2500000
941,lekki,... chevron lekki lagos,11,6,5,6,0,0,0,0,10,4700000
942,lekki,lekki phase 1 lekki lagos,7,4,3,4,0,0,0,1,7,2500000
943,lekki,ikota lekki lagos,5,3,2,3,0,0,0,0,7,1300000
944,lekki,ikate lekki lagos,11,6,5,6,0,0,0,1,10,6000000
945,lekki,chevron lekki lagos,9,5,4,5,1,0,0,1,9,4000000
946,lekki,ikota lekki lagos,11,6,5,6,0,0,0,0,10,4700000
947,lekki,lekki phase 1 lekki lagos,7,4,3,4,0,0,0,1,7,2500000
948,lekki,lekki phase 1 lekki lagos,9,5,4,5,0,0,0,1,9,3500000
949,lekki,jakande lekki lagos,7,4,3,4,0,0,0,1,7,2500000
950,lekki,lekki phase one lekki phase 1 lekki lagos,4,2,2,2,1,0,0,1,6,1800000
951,lekki,ikate lekki lagos,10,5,5,5,1,1,1,1,9,5000000
952,lekki,lekki phase 1 lekki lagos,4,2,2,2,0,0,0,0,6,1200000
953,lekki,behind prime water ikate lekki lagos,5,3,2,3,0,0,0,1,7,2000000
954,lekki,off fola osibo lekki phase 1 lekki lagos,7,4,3,4,1,0,0,1,7,3000000
955,lekki,ikota estate ikota lekki lagos,5,3,2,3,0,0,0,1,7,2000000
956,lekki,idado idado lekki lagos,3,2,1,2,0,0,0,0,6,1300000
957,lekki,idado idado lekki lagos,7,4,3,4,0,0,0,0,7,2000000
958,lekki,bourdillion court chevron lekki lagos,7,4,3,4,1,0,0,1,7,3000000
959,lekki,lekki garden. chevron 2 chevron lekki lagos,9,5,4,5,0,0,0,1,9,3500000
960,lekki,"lekki garden phase 2,opposite abraham adesanya abraham adesanya estate ajah lagos",7,4,3,4,0,0,0,0,7,2000000
961,lekki,ikota villa ikota lekki lagos,7,4,3,4,0,0,0,0,7,2000000
962,lekki,lekki phase 1 lekki lagos,11,6,5,6,1,1,0,1,10,6200000
963,lekki,.. lekki phase 1 lekki lagos,7,4,3,4,0,0,0,1,7,2500000
964,lekki,lekki phase 1 lekki lagos,7,4,3,4,0,0,0,1,7,2800000
965,lekki,ikate lekki lagos,11,6,5,6,1,1,0,1,10,6200000
966,lekki,ikate lekki lagos,5,3,2,3,0,0,0,1,7,2000000
967,lekki,osapa london lekki lagos,9,5,4,5,0,0,0,1,9,3500000
968,lekki,osapa london lekki lagos,11,6,5,6,0,0,0,0,10,4700000
969,lekki,osapa lekki phase 2 lekki lagos,11,6,5,6,0,0,0,0,10,5000000
970,lekki,ikota lekki lagos,9,5,4,5,0,0,0,1,9,3500000
971,lekki,ikate ikate lekki lagos,7,4,3,4,1,1,1,1,7,3500000
972,lekki,spa road ologolo lekki lagos,7,4,3,4,0,0,0,0,7,2000000
973,lekki,.. lekki phase 1 lekki lagos,4,2,2,2,1,1,1,1,6,3000000
974,lekki,lekki phase 1 lekki lagos,4,2,2,2,1,0,0,1,6,1700000
975,lekki,ikota lekki lagos,9,5,4,5,0,0,0,1,9,3500000
976,lekki,ikate lekki lagos,7,4,3,4,0,0,0,1,7,2500000
977,lekki,orchid lekki lagos,7,4,3,4,0,0,0,1,7,2500000
978,lekki,off admiralty way lekki phase 1 lekki lagos,9,5,4,5,1,0,0,1,9,4000000
979,lekki,orchid lekki phase 2 lekki lagos,9,5,4,5,0,0,0,1,9,3500000
980,lekki,spg road igbo efon lekki lagos,3,2,1,2,0,0,0,0,6,900000
981,lekki,chevy view chevron lekki lagos,7,4,3,4,0,0,0,0,7,2200000
982,lekki,idado idado lekki lagos,7,4,3,4,0,0,0,1,7,2500000
983,lekki,osapa london lekki lagos,7,4,3,4,0,0,0,0,7,2000000
984,lekki,alpha beach lekki lagos,7,4,3,4,0,0,0,0,7,2000000
985,lekki,lekki lekki phase 1 lekki lagos,9,5,4,5,1,0,0,1,9,4000000
986,lekki,chevy view estate chevron lekki lagos,2,1,1,1,0,0,0,1,4,1000000
987,lekki,agungi lekki lagos,7,4,3,4,0,0,0,0,7,2000000
988,lekki,oral estate oral estate lekki lagos,7,4,3,4,0,0,0,0,7,2000000
989,lekki,off admiralty way lekki phase 1 lekki lagos,7,4,3,4,1,1,1,1,7,4000000
990,lekki,idado estate chevron lekki lagos,11,6,5,6,0,0,0,0,10,4700000
991,lekki,ikate lekki lagos,11,6,5,6,0,0,0,1,10,6000000
992,lekki,.. lekki phase 1 lekki lagos,5,3,2,3,0,0,0,1,7,2200000
993,lekki,bourdillon court chevron lekki lagos,9,5,4,5,0,0,0,1,9,3500000
994,lekki," lakowe, otunla ibeju lekki lagos",5,3,2,3,0,0,0,0,7,1000000
995,lekki,chevron lekki lagos,9,5,4,5,0,0,0,1,9,3500000
996,lekki,lekki phase 1 lekki lagos,2,1,1,1,1,0,0,1,4,1200000
997,lekki,lekki phase 1 lekki lagos,6,3,3,3,1,1,1,1,7,3500000
998,lekki,jakande lekki lagos,7,4,3,4,0,0,0,1,7,2500000
999,lekki,lekki phase 1 lekki lagos,9,5,4,5,1,1,1,1,9,5500000
1000,lekki,agungi lekki lagos,7,4,3,4,0,0,0,0,7,2000000
1001,lekki,- lekki phase 1 lekki lagos,7,4,3,4,1,1,1,1,7,4300000
1002,lekki,off providence road lekki phase 1 lekki lagos,2,1,1,1,1,1,1,1,4,1500000
1003,lekki,adebayo doherty lekki phase 1 lekki lagos,7,4,3,4,1,1,1,1,7,3500000
1004,lekki,william st chevron lekki lagos,9,5,4,5,0,0,0,1,9,3500000
1005,lekki,ikota lekki lagos,9,5,4,5,0,0,0,1,9,3500000
1006,lekki,off admiralty way lekki phase 1 lekki lagos,7,4,3,4,1,1,1,1,7,3500000
1007,lekki,off admiralty way lekki phase 1 lekki lagos,7,4,3,4,0,0,0,1,7,2500000
1008,lekki,off admiralty way lekki phase 1 lekki lagos,7,4,3,4,1,0,0,1,7,3000000
1009,lekki,off admiralty way lekki phase 1 lekki lagos,7,4,3,4,1,0,0,1,7,3000000
1010,lekki,off admiralty way lekki phase 1 lekki lagos,7,4,3,4,1,1,1,1,7,3500000
1011,lekki,... ikate lekki lagos,7,4,3,4,1,1,1,1,7,4000000
1012,lekki,... chevron lekki lagos,11,6,5,6,0,0,0,0,10,4700000
1013,lekki,nicon town lekki lagos,9,5,4,5,0,0,0,1,9,3500000
1014,lekki,osapa lekki phase 1 lekki lagos,9,5,4,5,1,0,0,1,9,4000000
1015,lekki,lekki phase 1 lekki lagos,11,6,5,6,1,1,0,1,10,6200000
1016,lekki,osapa london lekki lagos,7,4,3,4,1,1,1,1,7,3500000
1017,lekki,lekki lekki phase 1 lekki lagos,7,4,3,4,1,0,0,1,7,3000000
1018,lekki,- lekki phase 1 lekki lagos,7,4,3,4,0,0,0,1,7,2700000
1019,lekki,lekki phase 1 estate lekki phase 1 lekki lagos,11,6,5,6,1,1,0,1,10,6200000
1020,lekki,- lekki phase 1 lekki lagos,7,4,3,4,0,0,0,1,7,2500000
1021,lekki,lekki phase 1 lekki lagos,4,2,2,2,1,1,1,1,6,2500000
1022,lekki,jakande lekki lagos,10,5,5,5,0,0,0,1,9,3500000
1023,lekki,ikota villa ikota lekki lagos,8,4,4,4,0,0,0,1,7,2500000
1024,lekki,ikate lekki lagos,10,5,5,5,1,1,1,1,9,5500000
1025,lekki,osapa london lekki lagos,9,5,4,5,0,0,0,1,9,3500000
1026,lekki,lekki phase 1 lekki lagos,7,4,3,4,1,1,1,1,7,3500000
1027,lekki,lekki phase 1 lekki lagos,5,3,2,3,0,0,0,1,7,2400000
1028,lekki,lekki phase 1 lekki lagos,11,6,5,6,1,1,0,1,10,6200000
1029,lekki,.. agungi lekki lagos,4,2,2,2,1,1,1,1,6,2000000
1030,lekki,chevy view chevron lekki lagos,8,4,4,4,1,1,1,1,7,4000000
1031,lekki,- lekki phase 1 lekki lagos,7,4,3,4,0,0,0,1,7,2800000
1032,lekki,agungi lekki lagos,9,5,4,5,0,0,0,1,9,3500000
1033,lekki,orchid lekki lagos,9,5,4,5,0,0,0,1,9,3500000
1034,lekki,chevron lekki lagos,11,6,5,6,0,0,0,0,10,5000000
1035,lekki,ilasan lekki lagos,5,3,2,3,0,0,0,1,7,2200000
1036,lekki,- agungi lekki lagos,5,3,2,3,0,0,0,1,7,2000000
1037,lekki,lekki phase 1 lekki lagos,7,4,3,4,1,0,0,1,7,3000000
1038,lekki,ologolo lekki lagos,9,5,4,5,0,0,0,1,9,3500000
1039,lekki,ikota lekki lagos,9,5,4,5,0,0,0,1,9,3500000
1040,lekki,chevron lekki lagos,7,4,3,4,0,0,0,1,7,2500000
1041,lekki,ologolo lekki lagos,9,5,4,5,0,0,0,1,9,3500000
1042,lekki,lekki phase 1 lekki lagos,7,4,3,4,1,1,1,1,7,4000000
1043,lekki,lekki phase 1 lekki lagos,9,5,4,5,1,0,1,1,9,4500000
1044,lekki,chisco ikate lekki lagos,11,6,5,6,0,0,0,0,10,4700000
1045,lekki,osapa osapa london lekki lagos,9,5,4,5,1,1,1,1,9,5600000
1046,lekki," lucky osujie, lekki palm city estate ado ajah lagos",9,5,4,5,0,0,0,1,9,3500000
1047,lekki,kanal residence osapa london lekki lagos,9,5,4,5,0,0,0,1,9,3500000
1048,lekki,primewater estate ikate lekki lagos,7,4,3,4,0,0,0,1,7,2500000
1049,lekki,ikota ikota lekki lagos,9,5,4,5,0,0,0,1,9,3500000
1050,lekki,off admiralty road lekki phase 1 lekki lagos,2,1,1,1,1,1,1,1,4,1400000
1051,lekki,gbola salami agungi lekki lagos,7,4,3,4,0,0,0,0,7,2000000
1052,lekki,ikota villa estate ikota lekki lagos,7,4,3,4,0,0,0,0,7,2000000
1053,lekki,jinadu igbo efon lekki lagos,7,4,3,4,0,0,0,0,7,2000000
1054,lekki," safe court estate, beside spar, ikate lekki lagos",7,4,3,4,1,0,0,1,7,3000000
1055,lekki,osapa london lekki lagos,5,3,2,3,0,0,0,0,7,1500000
1056,lekki,lekki phase 1 lekki lagos,10,5,5,5,1,0,0,1,9,4000000
1057,lekki,lekki phase 1 lekki lagos,7,4,3,4,0,0,0,1,7,2500000
1058,lekki,lekki phase 1 lekki lagos,5,3,2,3,1,1,1,1,7,3500000
1059,lekki,spg road ologolo lekki lagos,7,4,3,4,0,0,0,0,7,2000000
1060,lekki,lekki phase 1 lekki lagos,3,2,1,2,1,1,1,1,6,2500000
1061,lekki,osapa london lekki lagos,7,4,3,4,0,0,0,1,7,2500000
1062,lekki,off ola dimeji alo lekki phase 1 lekki lagos,11,6,5,6,0,0,0,1,10,5500000
1063,lekki," orchid hotel road, chevron toll gate chevron lekki lagos",2,1,1,1,1,1,1,1,4,2000000
1064,lekki,ikota lekki lagos,8,4,4,4,0,0,0,1,7,2500000
1065,lekki,alpha beach road igbo efon lekki lagos,7,4,3,4,0,0,0,0,7,2200000
1066,lekki,new road igbo efon lekki lagos,7,4,3,4,0,0,0,0,7,2000000
1067,lekki," oluwanisola estate, chevron lekki lagos",7,4,3,4,1,0,0,1,7,3000000
1068,lekki,chevron lekki lagos,7,4,3,4,0,0,0,0,7,2000000
1069,lekki,chevron conservative chevron lekki lagos,11,6,5,6,0,0,0,0,10,4700000
1070,lekki,osapa london lekki lagos,2,1,1,1,0,0,0,0,4,700000
1071,lekki,off freedom way lekki phase 1 lekki lagos,9,5,4,5,1,0,1,1,9,4500000
1072,lekki,alpha beach road igbo efon lekki lagos,7,4,3,4,0,0,0,0,7,2000000
1073,lekki," ikota villa estate, ikota lekki lagos",9,5,4,5,0,0,0,1,9,3500000
1074,lekki,ikota ikota lekki lagos,11,6,5,6,0,0,0,0,10,4700000
1075,lekki,orchid road ikota lekki lagos,9,5,4,5,0,0,0,1,9,3500000
1076,lekki,lekki phase 1 lekki phase 1 lekki lagos,5,3,2,3,1,1,1,1,7,3000000
1077,lekki,off kunesela road ikate lekki lagos,9,5,4,5,1,0,0,1,9,4000000
1078,lekki,ikate lekki lagos,2,1,1,1,0,0,0,0,4,500000
1079,lekki,lekki phase 1 lekki lagos,7,4,3,4,0,0,0,1,7,2500000
1080,lekki,ikate ikate lekki lagos,7,4,3,4,1,1,1,1,7,3500000
1081,lekki,... chevron lekki lagos,9,5,4,5,1,0,0,1,9,4000000
1082,lekki,- lekki phase 1 lekki lagos,5,3,2,3,1,1,0,1,7,2500000
1083,lekki,ilasan lekki lagos,3,2,1,2,0,0,0,0,6,900000
1084,lekki,prime water estate ikate lekki lagos,6,3,3,3,1,1,1,1,7,3000000
1085,lekki,ikota lekki phase 2 lekki lagos,9,5,4,5,0,0,0,1,9,3500000
1086,lekki,phase 1 lekki phase 1 lekki lagos,7,4,3,4,1,1,1,1,7,3500000
1087,lekki,lekki phase 1 lekki lagos,7,4,3,4,1,1,1,1,7,3500000
1088,lekki,off admiralty way lekki phase 1 lekki lagos,5,3,2,3,0,0,0,1,7,2000000
1089,lekki,off admiralty way lekki phase 1 lekki lagos,7,4,3,4,0,0,0,1,7,2800000
1090,lekki,off domino road agungi lekki lagos,5,3,2,3,0,0,0,1,7,2000000
1091,lekki,off durosinmi etti lekki phase 1 lekki lagos,7,4,3,4,0,0,0,1,7,2500000
1092,lekki,off admiralty way lekki phase 1 lekki lagos,5,3,2,3,1,1,1,1,7,3000000
1093,lekki,ologolo ologolo lekki lagos,11,6,5,6,1,1,0,1,10,6200000
1094,lekki,richmond gate estate ikate lekki lagos,9,5,4,5,1,1,1,1,9,5500000
1095,lekki,off admiralty way lekki phase 1 lekki lagos,7,4,3,4,0,0,0,1,7,2500000
1096,lekki,northpointe estate chevron lekki lagos,9,5,4,5,0,0,0,1,9,3500000
1097,lekki,osapa jakande lekki lagos,9,5,4,5,0,0,0,1,9,3500000
1098,lekki,chevron chevron lekki lagos,9,5,4,5,0,0,0,1,9,3500000
1099,lekki,idado idado lekki lagos,5,3,2,3,0,0,0,1,7,2000000
1100,lekki,oral oral estate lekki lagos,9,5,4,5,0,0,0,1,9,3500000
1101,lekki,osapa osapa london lekki lagos,7,4,3,4,0,0,0,1,7,2500000
1102,lekki,salem ilasan lekki lagos,7,4,3,4,0,0,0,0,7,2000000
1103,lekki,lekki phase 1 lekki lagos,6,3,3,3,1,1,1,1,7,3500000
1104,lekki,lekki phase 1 lekki lagos,2,1,1,1,1,0,0,1,4,1200000
1105,lekki,lekki phase 1 lekki lagos,2,1,1,1,1,0,0,1,4,1200000
1106,lekki,chevron lekki lagos,5,3,2,3,0,0,0,1,7,2000000
1107,lekki,ikate ikate lekki lagos,7,4,3,4,1,1,1,1,7,3500000
1108,lekki,jakande lekki lagos,6,3,3,3,1,1,0,1,7,2500000
1109,lekki,orchid road lekki chevron lekki lagos,8,4,4,4,1,0,0,1,7,3000000
1110,lekki,"off victoria arobieke street, phase1 lekki phase 1 lekki lagos",8,4,4,4,1,1,1,1,7,3500000
1111,lekki,.. lekki phase 1 lekki lagos,9,5,4,5,1,0,1,1,9,4600000
1112,lekki,richmond gate estate ikate lekki lagos,7,4,3,4,0,0,0,1,7,2500000
1113,lekki,lekki phase 1 lekki lagos,8,4,4,4,0,0,0,1,7,2500000
1114,lekki,orchid ikota lekki lagos,2,1,1,1,1,0,0,1,4,1200000
1115,lekki,.. ikota lekki lagos,4,2,2,2,0,0,0,0,6,1200000
1116,lekki,agungi lekki lagos,8,4,4,4,0,0,0,1,7,2500000
1117,lekki,ikota lekki lagos,9,5,4,5,1,0,0,1,9,4000000
1118,lekki,maruwa lekki phase 1 lekki lagos,7,4,3,4,1,0,0,1,7,3000000
1119,lekki,agungi lekki lagos,7,4,3,4,0,0,0,0,7,2000000
1120,lekki,ikota lekki lagos,9,5,4,5,0,0,0,1,9,3500000
1121,lekki,... osapa london lekki lagos,11,6,5,6,0,0,0,0,10,4700000
1122,lekki,chevron lekki lagos,11,6,5,6,0,0,0,0,10,4700000
1123,lekki,... osapa london lekki lagos,9,5,4,5,0,0,0,1,9,3700000
1124,lekki,lekki phase 1 lekki lagos,7,4,3,4,1,1,1,1,7,3500000
1125,lekki,lekki phase 1 lekki lagos,9,5,4,5,1,1,1,1,9,5600000
1126,lekki,lekki phase 1 lekki lagos,11,6,5,6,1,1,0,1,10,6200000
1127,lekki,lekki right hand side lekki phase 1 lekki lagos,7,4,3,4,1,1,1,1,7,4300000
1128,lekki,lekki phase 1 lekki lagos,7,4,3,4,1,0,0,1,7,3000000
1129,lekki,lekki phase 1 lekki lagos,9,5,4,5,1,1,1,1,9,5600000
1130,lekki,lekki scheme 2 ajah lagos,9,5,4,5,0,0,0,1,9,3500000
1131,lekki,lekki scheme 2 ajah lagos,9,5,4,5,0,0,0,1,9,3500000
1132,lekki,lekki scheme 2 ajah lagos,7,4,3,4,0,0,0,0,7,2000000
1133,lekki,chevron lekki lagos,9,5,4,5,0,0,0,1,9,3500000
1134,lekki,lekki phase 2 lekki lagos,9,5,4,5,0,0,0,1,9,3500000
1135,lekki," eleganza gardens, vgc lekki lagos",7,4,3,4,0,0,0,0,7,2000000
1136,lekki,chevron lekki lagos,7,4,3,4,0,0,0,1,7,2500000
1137,lekki,off admiralty way lekki phase 1 lekki lagos,11,6,5,6,0,0,0,0,10,5000000
1138,lekki,ikate ikate lekki lagos,5,3,2,3,1,1,1,1,7,3000000
1139,lekki,chevron lekki lagos,7,4,3,4,0,0,0,1,7,2800000
1140,lekki,chevron lekki lagos,9,5,4,5,1,0,0,1,9,4000000
1141,lekki,.. agungi lekki lagos,7,4,3,4,0,0,0,0,7,2000000
1142,lekki,- ikate lekki lagos,2,1,1,1,0,0,0,1,4,815000
1143,lekki,lekki phase 1 lekki lagos,7,4,3,4,1,1,1,1,7,4300000
1144,lekki,manor garden estate vgc lekki lagos,9,5,4,5,0,0,0,1,9,3500000
1145,lekki,osapa london lekki lagos,2,1,1,1,0,0,0,1,4,800000
1146,lekki,idado idado lekki lagos,5,3,2,3,0,0,0,1,7,2000000
1147,lekki,ikate lekki lagos,7,4,3,4,0,0,0,0,7,2000000
1148,lekki,... ikate lekki lagos,7,4,3,4,1,0,0,1,7,3000000
1149,lekki,chevron lekki lagos,9,5,4,5,0,0,0,1,9,3500000
1150,lekki,lekki phase 1 lekki phase 1 lekki lagos,9,5,4,5,1,1,1,1,9,5000000
1151,lekki,off admiralty way lekki phase 1 lekki lagos,5,3,2,3,1,1,0,1,7,2500000
1152,lekki,off admiralty way lekki phase 1 lekki lagos,7,4,3,4,0,0,0,1,7,2800000
1153,lekki,off providence road lekki phase 1 lekki lagos,9,5,4,5,1,1,1,1,9,5600000
1154,lekki,.. ikate lekki lagos,11,6,5,6,0,0,0,1,10,6000000
1155,lekki,- lekki phase 1 lekki lagos,11,6,5,6,1,1,0,1,10,6200000
1156,lekki,lekki phase 1 lekki lagos,9,5,4,5,1,1,1,1,9,5000000
1157,lekki,ilasan lekki lagos,11,6,5,6,0,0,0,0,10,4700000
1158,lekki,ikate ikate lekki lagos,9,5,4,5,1,0,1,1,9,4500000
1159,lekki,ologolo lekki lagos,7,4,3,4,1,0,0,1,7,3000000
1160,lekki,spg igbo efon lekki lagos,3,2,1,2,0,0,0,0,6,1300000
1161,lekki,lekki phase 1 lekki lagos,5,3,2,3,1,1,1,1,7,3000000
1162,lekki,lekki phase 1 lekki lagos,11,6,5,6,1,1,0,1,10,6200000
1163,lekki,nicon town lekki lagos,11,6,5,6,1,1,0,1,10,6200000
1164,lekki,lekki phase 1 lekki lagos,9,5,4,5,1,1,1,1,9,5600000
1165,lekki,lekki phase 1 lekki lagos,9,5,4,5,1,0,1,1,9,4500000
1166,lekki,pinnock estate osapa london lekki lagos,11,6,5,6,0,0,0,1,10,6000000
1167,lekki,lekki phase 1 lekki lagos,2,1,1,1,1,1,1,1,4,2000000
1168,lekki,lekki phase 1 lekki lagos,2,1,1,1,1,1,1,1,4,2000000
1169,lekki," car wash bridge, agungi agungi lekki lagos",9,5,4,5,0,0,0,1,9,3500000
1170,lekki,jakande lekki lagos,6,3,3,3,1,1,0,1,7,2500000
1171,lekki,lekki phase 1 lekki lagos,6,3,3,3,0,0,0,1,7,2200000
1172,lekki,lekki phase 1 lekki lagos,6,3,3,3,1,1,1,1,7,3500000
1173,lekki,ikota lekki lagos,8,4,4,4,1,1,1,1,7,4000000
1174,lekki,chevy view chevron lekki lagos,2,1,1,1,0,0,0,1,4,1000000
1175,lekki,lekki phase 1 lekki lagos,6,3,3,3,1,1,0,1,7,2500000
1176,lekki,lekki phase 1 lekki lagos,6,3,3,3,1,1,0,1,7,2500000
1177,lekki,marwa lekki phase 1 lekki lagos,6,3,3,3,1,1,1,1,7,3000000
1178,lekki,osapa london lekki lagos,4,2,2,2,1,1,1,1,6,2200000
1179,lekki,lekki lekki phase 1 lekki lagos,7,4,3,4,1,1,1,1,7,4300000
1180,lekki,lekki lekki phase 1 lekki lagos,7,4,3,4,0,0,0,1,7,2500000
1181,lekki,- lekki phase 1 lekki lagos,7,4,3,4,0,0,0,1,7,2700000
1182,lekki,off admiralty way lekki phase 1 lekki lagos,7,4,3,4,1,1,1,1,7,3500000
1183,lekki,off freedom way lekki phase 1 lekki lagos,5,3,2,3,1,1,1,1,7,3500000
1184,lekki,- lekki phase 1 lekki lagos,7,4,3,4,1,1,1,1,7,4300000
1185,lekki,off admiralty road lekki phase 1 lekki lagos,9,5,4,5,1,1,1,1,9,5600000
1186,lekki,lekki right lekki phase 1 lekki lagos,7,4,3,4,1,1,1,1,7,3500000
1187,lekki,ikota lekki lagos,11,6,5,6,0,0,0,0,10,4700000
1188,lekki,lekki phase 1 lekki lagos,7,4,3,4,0,0,0,1,7,2500000
1189,lekki,chevron lekki lagos,7,4,3,4,1,1,1,1,7,3500000
1190,lekki,ologolo lekki lagos,7,4,3,4,0,0,0,0,7,2000000
1191,lekki,orchid road lekki phase 2 lekki lagos,9,5,4,5,0,0,0,1,9,3500000
1192,lekki,agungi lekki lagos,9,5,4,5,0,0,0,1,9,3500000
1193,lekki,chevron lekki lagos,11,6,5,6,0,0,0,0,10,4700000
1194,lekki,.. ikota lekki lagos,5,3,2,3,0,0,0,0,7,1200000
1195,lekki,mini serviced estate osapa london lekki lagos,11,6,5,6,0,0,0,1,10,6000000
1196,lekki,prime water estate lekki phase 1 lekki lagos,7,4,3,4,0,0,0,1,7,2500000
1197,lekki,osapa osapa london lekki lagos,9,5,4,5,0,0,0,1,9,3500000
1198,lekki,northern foreshore chevron lekki lagos,9,5,4,5,0,0,0,1,9,3500000
1199,lekki,off freedom way ikate lekki lagos,7,4,3,4,0,0,0,0,7,2000000
1200,lekki,off freedom way lekki phase 1 lekki lagos,9,5,4,5,0,0,0,1,9,3800000
1201,lekki,alternative route chevron lekki lagos,11,6,5,6,0,0,0,0,10,4700000
1202,lekki,off freedom way ikate lekki lagos,5,3,2,3,0,0,0,1,7,2000000
1203,lekki,vintage estate close to shoprite jakande lekki lagos,9,5,4,5,1,0,0,1,9,4000000
1204,lekki,ikota lekki lagos,9,5,4,5,0,0,0,1,9,3500000
1205,lekki,osapa lekki phase 2 lekki lagos,11,6,5,6,0,0,0,0,10,5000000
1206,lekki,chevron lekki lagos,11,6,5,6,0,0,0,0,10,4700000
1207,lekki,agungi lekki lagos,2,1,1,1,0,0,0,1,4,900000
1208,lekki,.. osapa london lekki lagos,7,4,3,4,0,0,0,0,7,2000000
1209,lekki,agungi agungi lekki lagos,5,3,2,3,0,0,0,0,7,1700000
1210,lekki,.. lekki phase 1 lekki lagos,11,6,5,6,1,1,0,1,10,6200000
1211,lekki,lekki phase 1 lekki lagos,7,4,3,4,1,1,1,1,7,4300000
1212,lekki,chevy view chevron lekki lagos,11,6,5,6,0,0,0,0,10,4700000
1213,lekki,chevron chevron lekki lagos,7,4,3,4,0,0,0,0,7,2200000
1214,lekki,lekki phase 1 lekki lagos,9,5,4,5,1,1,1,1,9,5600000
1215,lekki,osapa london lekki lagos,2,1,1,1,0,0,0,0,4,600000
1216,lekki,- lekki phase 1 lekki lagos,7,4,3,4,1,0,0,1,7,3000000
1217,lekki,lekki phase 1 lekki lagos,9,5,4,5,1,0,1,1,9,4800000
1218,lekki," eleganza gardens, vgc lekki lagos",5,3,2,3,0,0,0,0,7,1200000
1219,lekki,agungi lekki lagos,9,5,4,5,0,0,0,1,9,3500000
1220,lekki,oral oral estate lekki lagos,5,3,2,3,0,0,0,0,7,1700000
1221,lekki,osapa london lekki lagos,9,5,4,5,1,0,0,1,9,4000000
1222,lekki,jakande lekki lagos,7,4,3,4,0,0,0,1,7,2800000
1223,lekki,.. ikota lekki lagos,5,3,2,3,0,0,0,0,7,1300000
1224,lekki,lekki phase 1 lekki lagos,9,5,4,5,1,1,1,1,9,5500000
1225,lekki,- osapa london lekki lagos,7,4,3,4,0,0,0,1,7,2500000
1226,lekki,nicon town lekki lagos,11,6,5,6,1,1,0,1,10,6200000
1227,lekki,lekki phase 1 lekki lagos,15,8,7,8,1,1,0,1,10,7000000
1228,lekki,off admiralty way lekki phase 1 lekki lagos,7,4,3,4,1,1,1,1,7,4000000
1229,lekki,maruwa lekki phase 1 lekki lagos,7,4,3,4,0,0,0,1,7,2800000
1230,lekki,off admiralty way lekki phase 1 lekki lagos,7,4,3,4,1,0,0,1,7,3300000
1231,lekki,pinnock estate osapa london lekki lagos,11,6,5,6,0,0,0,1,10,6000000
1232,lekki,norther foreshore lekki phase 1 lekki lagos,8,4,4,4,1,1,1,1,7,3500000
1233,lekki,osapa london lekki lagos,5,3,2,3,0,0,0,0,7,1800000
1234,lekki,osapa london lekki lagos,7,4,3,4,0,0,0,1,7,2500000
1235,lekki,ikota lekki lagos,7,4,3,4,0,0,0,0,7,2000000
1236,lekki,chevy view estate chevron lekki lagos,9,5,4,5,1,0,0,1,9,4000000
1237,lekki,osapa london lekki lagos,7,4,3,4,0,0,0,0,7,2000000
1238,lekki,lekki phase 1 lekki lagos,7,4,3,4,0,0,0,1,7,2500000
1239,lekki,chevron lekki lagos,7,4,3,4,1,0,0,1,7,3000000
1240,lekki,ikota lekki lagos,7,4,3,4,0,0,0,0,7,2000000
1241,lekki,chevron lekki lagos,7,4,3,4,0,0,0,1,7,2500000
1242,lekki,lekki phase 1 lekki lagos,7,4,3,4,1,1,1,1,7,4300000
1243,lekki,lekki phase 1 lekki lagos,7,4,3,4,1,1,1,1,7,4000000
1244,lekki,lekki phase 1 lekki lagos,7,4,3,4,1,1,1,1,7,3500000
1245,lekki,lekki phase 1 lekki lagos,7,4,3,4,1,1,1,1,7,3500000
1246,lekki,oniru victoria island lagos,11,6,5,6,1,1,0,1,10,6200000
1247,lekki,lekki phase 1 lekki lagos,7,4,3,4,1,1,1,1,7,3500000
1248,lekki,lekki phase 1 lekki lagos,12,6,6,6,1,1,0,1,10,6200000
1249,lekki,.. lekki phase 1 lekki lagos,7,4,3,4,1,1,1,1,7,4000000
1250,lekki,lekki phase 1 lekki lagos,7,4,3,4,0,0,0,1,7,2500000
1251,lekki,chevron lekki lagos,2,1,1,1,1,1,1,1,4,1500000
1252,lekki,chevron lekki lagos,7,4,3,4,0,0,0,1,7,2500000
1253,lekki,richmond gate estate ikate lekki lagos,9,5,4,5,1,0,1,1,9,4500000
1254,lekki,admiralty way lekki phase 1 lekki lagos,3,2,1,2,0,0,0,1,6,1500000
1255,lekki,lekki phase 1 lekki lagos,11,6,5,6,0,0,0,1,10,6000000
1256,lekki,off palace road ikate lekki lagos,6,3,3,3,0,0,0,1,7,2000000
1257,lekki,lekki phase one lekki phase 1 lekki lagos,3,2,1,2,0,0,0,1,6,1500000
1258,lekki,idado idado lekki lagos,7,4,3,4,0,0,0,0,7,2000000
1259,lekki,osapa osapa london lekki lagos,5,3,2,3,0,0,0,1,7,2300000
1260,lekki," ologolo, ologolo lekki lagos",7,4,3,4,0,0,0,0,7,2000000
1261,lekki,lekki phase 1 lekki lagos,11,6,5,6,0,0,0,1,10,6000000
1262,lekki,ikota estate ikota lekki lagos,9,5,4,5,0,0,0,1,9,3500000
1263,lekki,.. ikota lekki lagos,10,5,5,5,0,0,0,1,9,3500000
1264,lekki," golf, lakowe ibeju lekki lagos",5,3,2,3,0,0,0,0,7,1000000
1265,lekki,spring bay estate ikate lekki lagos,7,4,3,4,1,1,1,1,7,3500000
1266,lekki,off admiralty way lekki phase 1 lekki lagos,11,6,5,6,1,1,0,1,10,6200000
1267,lekki,off adebayo dorothy lekki phase 1 lekki lagos,5,3,2,3,1,1,0,1,7,2500000
1268,lekki,off admiralty road lekki phase 1 lekki lagos,9,5,4,5,1,1,1,1,9,5600000
1269,lekki,off admiralty way lekki phase 1 lekki lagos,7,4,3,4,1,1,1,1,7,3600000
1270,lekki,. lekki phase 1 lekki lagos,7,4,3,4,0,0,0,0,7,2000000
1271,lekki,- lekki phase 1 lekki lagos,7,4,3,4,1,1,1,1,7,4300000
1272,lekki,freedom way lekki phase 1 lekki lagos,5,3,2,3,0,0,0,0,7,1600000
1273,lekki,behind tantalizer lekki phase 1 lekki lagos,9,5,4,5,1,1,1,1,9,5600000
1274,lekki,ikota ikota lekki lagos,9,5,4,5,0,0,0,1,9,3500000
1275,lekki,agungi agungi lekki lagos,4,2,2,2,1,0,0,1,6,1800000
1276,lekki,eletu osapa london lekki lagos,9,5,4,5,0,0,0,1,9,3500000
1277,lekki,bridge gate estate agungi lekki lagos,2,1,1,1,0,0,0,1,4,850000
1278,lekki,chevron lekki lagos,8,4,4,4,1,0,0,1,7,3000000
1279,lekki,chevron alternative chevron lekki lagos,10,5,5,5,1,0,0,1,9,4000000
1280,lekki,oral estate lekki lagos,8,4,4,4,1,0,0,1,7,3000000
1281,lekki,ikota villa ikota lekki lagos,8,4,4,4,1,1,1,1,7,4000000
1282,lekki,lekki phase 1 lekki lagos,8,4,4,4,1,0,0,1,7,3000000
1283,lekki,chevron lekki lagos,7,3,4,3,1,1,1,1,7,3000000
1284,lekki,osapa london lekki lagos,11,6,5,6,0,0,0,0,10,4700000
1285,lekki,off admiralty way lekki phase 1 lekki lagos,7,4,3,4,0,0,0,1,7,2800000
1286,lekki,off admiralty way lekki phase 1 lekki lagos,5,3,2,3,1,1,0,1,7,2500000
1287,lekki,off admiralty way lekki phase 1 lekki lagos,5,3,2,3,1,1,1,1,7,3000000
1288,lekki,ikate estate ikate lekki lagos,5,3,2,3,0,0,0,1,7,2000000
1289,lekki,off admiralty way lekki phase 1 lekki lagos,5,3,2,3,1,1,0,1,7,2500000
1290,lekki,denco court ikate lekki lagos,9,5,4,5,0,0,0,1,9,3500000
1291,lekki,alternative route chevron lekki lagos,11,6,5,6,0,0,0,0,10,4700000
1292,lekki,lekki phase 1 lekki lagos,6,3,3,3,1,1,0,1,7,2500000
1293,lekki,agungi lekki lagos,6,3,3,3,0,0,0,0,7,1800000
1294,lekki,.. jakande lekki lagos,4,2,2,2,1,1,1,1,6,2000000
1295,lekki,lekki phase 1 lekki lagos,6,3,3,3,1,1,0,1,7,2500000
1296,lekki,lekki right lekki phase 1 lekki lagos,7,4,3,4,1,1,1,1,7,3500000
1297,lekki,kajola eleranigbe ibeju lekki lagos,7,4,3,4,0,0,0,0,7,2000000
1298,lekki,ikate ikate lekki lagos,7,4,3,4,1,1,1,1,7,3800000
1299,lekki," milverton estate, lekki lekki lagos",6,3,3,3,1,1,0,1,7,2500000
1300,lekki,chevy view chevron lekki lagos,7,4,3,4,0,0,0,1,7,2500000
1301,lekki,off freedom way ikate lekki lagos,5,3,2,3,0,0,0,1,7,2300000
1302,lekki,agungi agungi lekki lagos,5,3,2,3,0,0,0,1,7,2300000
1303,lekki,ikota lekki lagos,9,5,4,5,0,0,0,1,9,3500000
1304,lekki,ikota lekki lagos,2,1,1,1,0,0,0,1,4,800000
1305,lekki,osapa london lekki lagos,6,3,3,3,0,0,0,0,7,1700000
1306,lekki," orchid road,chevron tollgate chevron lekki lagos",2,1,1,1,0,0,0,0,4,500000
1307,lekki,gbetu road awoyaya off lekki epe expressway ajah lagos,12,6,6,6,0,0,0,0,10,4700000
1308,lekki,"tom ogboi street, itedo estate lekki phase 1 lekki lagos",3,2,1,2,0,0,0,1,6,1600000
1309,lekki,"muiz banire street opp imax cinema lekki phase 1, lekki lagos lekki phase 1 lekki lagos",7,4,3,4,1,1,1,1,7,4300000
1310,lekki,elegushi lekki phase 1 lekki lagos,7,4,3,4,0,0,0,0,7,2000000
1311,lekki,elegushi ikate lekki lagos,7,4,3,4,0,0,0,0,7,2000000
1312,lekki,elegushi ikate lekki lagos,6,3,3,3,0,0,0,1,7,2000000
1313,lekki,lekki phase1 lekki phase 1 lekki lagos,9,5,4,5,1,1,1,1,9,5600000
1314,lekki,lekki phase 1 lekki phase 1 lekki lagos,9,5,4,5,1,0,0,1,9,4000000
1315,lekki,... idado lekki lagos,7,4,3,4,0,0,0,0,7,2000000
1316,lekki,off alpha beach road igbo efon lekki lagos,11,6,5,6,0,0,0,0,10,4700000
1317,lekki,ilasan lekki lagos,7,4,3,4,0,0,0,0,7,2200000
1318,lekki,lekki phase1 lekki phase 1 lekki lagos,3,2,1,2,1,0,0,1,6,1700000
1319,lekki,chevy view estate chevron lekki lagos,9,5,4,5,0,0,0,1,9,3500000
1320,lekki,chevron lekki lagos,13,7,6,7,0,0,0,0,10,5500000
1321,lekki,gbangbala street ikate lekki lagos,7,4,3,4,0,0,0,1,7,2500000
1322,lekki,lekki right lekki phase 1 lekki lagos,9,5,4,5,1,0,1,1,9,4500000
1323,lekki,owode alpha beach igbo efon lekki lagos,3,2,1,2,0,0,0,0,6,900000
1324,lekki,road13 ikota lekki lagos,5,3,2,3,0,0,0,0,7,1500000
1325,lekki,admiralty home estate igbo efon lekki lagos,11,6,5,6,0,0,0,0,10,4700000
1326,lekki,off chevron drive chevron lekki lagos,9,5,4,5,0,0,0,1,9,3500000
1327,lekki,graceville court opposite ikate behind romay garden ilasan lekki lagos,2,1,1,1,0,0,0,0,4,400000
1328,lekki,ikate ikate lekki lagos,9,5,4,5,1,0,1,1,9,4500000
1329,lekki,off freedom road lekki phase 1 lekki phase 1 lekki lagos,3,2,1,2,0,0,0,0,6,900000
1330,lekki,spg ologolo lekki lagos,2,1,1,1,0,0,0,1,4,1100000
1331,lekki,cluster one estate ikota lekki lagos,7,4,3,4,0,0,0,0,7,2000000
1332,lekki,off fola osibo street lekki lekki lagos,2,1,1,1,1,1,1,1,4,1300000
1333,lekki,atlantic view estate igbo efon lekki lagos,9,5,4,5,0,0,0,1,9,3500000
1334,lekki,osapa osapa london lekki lagos,9,5,4,5,1,1,1,1,9,5600000
1335,lekki,providence street lekki phase 1 lekki lagos,2,1,1,1,1,1,1,1,4,1300000
1336,lekki,ocean breeze estate ologolo lekki lagos,7,4,3,4,0,0,0,1,7,2700000
1337,lekki,megamound ikota lekki lagos,7,4,3,4,0,0,0,1,7,2500000
1338,lekki,off admiralty road lekki phase 1 lekki lagos,2,1,1,1,1,1,1,1,4,1400000
1339,lekki,agungi lekki lagos,7,4,3,4,0,0,0,0,7,2000000
1340,lekki,lekki phase 1 lekki phase 1 lekki lagos,7,4,3,4,1,1,1,1,7,4300000
1341,lekki,canal west estate osapa london lekki lagos,11,6,5,6,0,0,0,0,10,4700000
1342,lekki,lovely estate @chevron alternative chevron lekki lagos,9,5,4,5,0,0,0,1,9,3500000
1343,lekki,leon garden chevron lekki lagos,9,5,4,5,0,0,0,1,9,3500000
1344,lekki,off orchid road lekki ikota lekki lagos,2,1,1,1,0,0,0,0,4,400000
1345,lekki,elf lekki phase 1 lekki lagos,5,3,2,3,0,0,0,1,7,2200000
1346,lekki,off alpha beach road igbo efon lekki lagos,4,2,2,2,0,0,0,0,6,900000
1347,lekki,lekki phase1 lekki phase 1 lekki lagos,9,5,4,5,1,1,1,1,9,5600000
1348,lekki,off alpha beach road igbo efon lekki lagos,7,4,3,4,0,0,0,0,7,2000000
1349,lekki,westend estate ikota lekki lagos,7,4,3,4,0,0,0,0,7,2000000
1350,lekki,maruwa lekki phase 1 lekki lagos,9,5,4,5,0,0,0,1,9,3800000
1351,lekki,chevron dirve chevron lekki lagos,9,5,4,5,0,0,0,1,9,3500000
1352,lekki,villa estate ikota lekki lagos,9,5,4,5,0,0,0,1,9,3500000
1353,lekki,pinnock beach estate lekki lagos,11,6,5,6,1,1,0,1,10,6200000
1354,lekki,lekki county road ikota lekki lagos,9,5,4,5,0,0,0,1,9,3500000
1355,lekki,west end estate ikota lekki lagos,7,4,3,4,0,0,0,0,7,2000000
1356,lekki,agungi lekki lagos,7,4,3,4,0,0,0,0,7,2000000
1357,lekki,orchid road chevron lekki lagos,9,5,4,5,0,0,0,1,9,3500000
1358,lekki,alexander court osapa london lekki lagos,7,4,3,4,0,0,0,1,7,2500000
1359,lekki,lekki phase1 lekki phase 1 lekki lagos,11,6,5,6,1,1,0,1,10,6200000
1360,lekki,safecourt estate badore ajah lagos,7,4,3,4,1,0,0,1,7,3000000
1361,lekki,maruwa lekki phase 1 lekki lagos,7,4,3,4,0,0,0,0,7,2200000
1362,lekki,lekki phase 1 lekki lagos,9,5,4,5,1,1,1,1,9,5600000
1363,lekki,oba amunsa estate agungi lekki lagos,12,6,6,6,0,0,0,0,10,4700000
1364,lekki,chevy view chevron lekki lagos,7,4,3,4,0,0,0,0,7,2000000
1365,lekki,allan balogun estate. agungi lekki lagos,2,1,1,1,0,0,0,0,4,550000
1366,lekki,ikate lekki lagos,5,3,2,3,0,0,0,1,7,2000000
1367,lekki," peninsula estate, orchid chevron lekki lagos",12,7,5,7,1,1,0,1,10,6800000
1368,lekki,ocean breeze estate ologolo lekki lagos,9,5,4,5,0,0,0,1,9,3500000
1369,lekki,oral estate chevron lekki lagos,2,1,1,1,0,0,0,0,4,400000
1370,lekki,off fola osibo lekki phase 1 lekki lagos,7,4,3,4,1,1,1,1,7,4300000
1371,lekki,bera estate chevron lekki lagos,9,5,4,5,1,0,0,1,9,4000000
1372,lekki,eleganzer garden vgc lekki lagos,11,6,5,6,0,0,0,0,10,4700000
1373,lekki,"orchid road, 2nd toll gate, lekki, lagos lekki phase 2 lekki lagos",9,5,4,5,1,0,0,1,9,4000000
1374,lekki,gated community ikate lekki lagos,11,6,5,6,0,0,0,1,10,5500000
1375,lekki,gated community ikate lekki lagos,11,6,5,6,0,0,0,1,10,6000000
1376,lekki,ologolo lekki lagos,11,6,5,6,1,1,0,1,10,6200000
1377,lekki,lekki county road ikota lekki lagos,9,5,4,5,0,0,0,1,9,3500000
1378,lekki,megamound ikota lekki lagos,9,5,4,5,0,0,0,1,9,3500000
1379,lekki,off road 14 lekki phase 1 lekki lagos,12,7,5,7,1,1,0,1,10,6800000
1380,lekki,- ilasan lekki lagos,7,4,3,4,0,0,0,0,7,2000000
1381,lekki,bera estate chevron lekki lagos,9,5,4,5,0,0,0,1,9,3500000
1382,lekki,lekki scheme 2 ogombo ajah lagos,9,5,4,5,0,0,0,1,9,3500000
1383,lekki,road 14 lekki phase 1 lekki lagos,11,6,5,6,1,1,0,1,10,6200000
1384,lekki,eleganzer garden vgc lekki lagos,11,6,5,6,0,0,0,0,10,4700000
1385,lekki,atlantic view estate igbo efon lekki lagos,2,1,1,1,0,0,0,0,4,400000
1386,lekki,chief collins street. lekki phase 1 lekki lagos,2,1,1,1,0,0,0,1,4,800000
1387,lekki,awkulu street off providence street lekki phase 1 lekki phase 1 lekki lagos,3,2,1,2,0,0,0,0,6,1100000
1388,lekki,ikate lekki lagos,9,5,4,5,0,0,0,1,9,3500000
1389,lekki,oba amunsan estate idado lekki lagos,11,6,5,6,0,0,0,0,10,4700000
1390,lekki,osapa london osapa london lekki lagos,3,2,1,2,0,0,0,0,6,1000000
1391,lekki,- ilasan lekki lagos,9,5,4,5,0,0,0,1,9,3500000
1392,lekki,gated estate @ologolo ologolo lekki lagos,9,5,4,5,0,0,0,1,9,3500000
1393,lekki,road16 ikota lekki lagos,3,2,1,2,0,0,0,0,6,900000
1394,lekki,ikota villa ikota lekki lagos,9,5,4,5,0,0,0,1,9,3500000
1395,lekki,megamound ikota lekki lagos,11,6,5,6,0,0,0,0,10,4700000
1396,lekki,ikate ikate lekki lagos,7,4,3,4,1,1,1,1,7,3500000
1397,lekki," napier garden estate, beside manor garden, ikota, lekki, lagos ikota lekki lagos",9,5,4,5,0,0,0,1,9,3800000
1398,lekki,kensular ikate lekki lagos,9,5,4,5,0,0,0,1,9,3500000
1399,lekki,osapa london osapa london lekki lagos,9,5,4,5,1,0,0,1,9,4000000
1400,lekki," lafiaji, lekki lagos",9,5,4,5,0,0,0,1,9,3800000
1401,lekki,oral estate chevron lekki lagos,7,4,3,4,0,0,0,0,7,2000000
1402,lekki,chevron axis lekki lagos,7,4,3,4,0,0,0,0,7,2200000
1403,lekki,off kensular ikate lekki lagos,7,4,3,4,0,0,0,0,7,2200000
1404,lekki,"tam ogboi street,off freedom way lekki phase 1 lekki phase 1 lekki lagos",7,4,3,4,1,0,0,1,7,3000000
1405,lekki,lekki phase1 lekki phase 1 lekki lagos,7,4,3,4,1,1,1,1,7,4300000
1406,lekki,off admiralty road lekki phase 1 lekki lagos,2,1,1,1,1,0,0,1,4,1200000
1407,lekki,ikate lekki lagos,11,6,5,6,0,0,0,0,10,4700000
1408,lekki,the address estate osapa london lekki lagos,9,5,4,5,1,1,1,1,9,5500000
1409,lekki,eleganzer garden vgc lekki lagos,9,5,4,5,0,0,0,1,9,3500000
1410,lekki,gated estate lekki phase 1 lekki lagos,11,6,5,6,1,1,0,1,10,6200000
1411,lekki,igbo efon lekki lagos,5,3,2,3,0,0,0,0,7,1000000
1412,lekki,oral estate oral estate lekki lagos,2,1,1,1,0,0,0,0,4,550000
1413,lekki,kusenla ikate lekki lagos,9,4,5,4,1,1,1,1,7,4300000
1414,lekki,lekki right lekki phase 1 lekki lagos,9,5,4,5,1,1,1,1,9,5200000
1415,lekki,ikate lekki lagos,3,2,1,2,0,0,0,0,6,900000
1416,lekki,primewaterview estate lekki phase 1 lekki lagos,10,5,5,5,0,0,0,1,9,3500000
1417,lekki,free trade zone ibeju lekki lagos,12,6,6,6,0,0,0,0,10,4700000
1418,lekki,lekki phase 2 lekki lagos,10,5,5,5,0,0,0,1,9,3500000
1419,lekki,lekki phase 1 lekki lagos,8,4,4,4,1,1,1,1,7,4300000
1420,lekki,ikota lekki lagos,7,4,3,4,0,0,0,0,7,2200000
1421,lekki,ikota lekki lagos,9,5,4,5,0,0,0,1,9,3500000
1422,lekki,- chevron lekki lagos,9,5,4,5,0,0,0,1,9,3500000
1423,lekki,opposite mega chicken ikota ikota lekki lagos,10,5,5,5,0,0,0,1,9,3500000
1424,lekki,chevron lekki lagos,9,5,4,5,0,0,0,1,9,3500000
1425,lekki,lekki phase 1 lekki lagos,11,6,5,6,1,1,0,1,10,6200000
1426,lekki,jakande jakande lekki lagos,5,3,2,3,0,0,0,1,7,2000000
1427,lekki,lekki lagos,10,5,5,5,0,0,0,1,9,3500000
1428,lekki,lekki lekki phase 1 lekki lagos,9,5,4,5,0,0,0,1,9,3500000
1429,lekki,osapa london lekki lagos,9,5,4,5,0,0,0,1,9,3500000
1430,lekki,ikate lekki lagos,9,5,4,5,1,1,1,1,9,5600000
1431,lekki,lekki phase 1 lekki lagos,8,4,4,4,1,1,1,1,7,3500000
1432,lekki,arcadia groove estate osapa london lekki lagos,11,6,5,6,1,1,0,1,10,6200000
1433,lekki,osapa osapa london lekki lagos,5,3,2,3,0,0,0,1,7,2000000
1434,lekki,- lekki phase 1 lekki lagos,9,5,4,5,0,0,0,1,9,3500000
1435,lekki,lekki phase 1 lekki lagos,8,4,4,4,1,0,0,1,7,3000000
1436,lekki,chevron lekki lagos,10,5,5,5,0,0,0,1,9,3500000
1437,lekki,lekki phase 1 lekki lagos,5,3,2,3,1,1,1,1,7,3500000
1438,lekki,lekki phase 1 lekki lagos,8,4,4,4,1,1,1,1,7,3500000
1439,lekki,ikota villa ikota lekki lagos,7,4,3,4,0,0,0,0,7,2000000
1440,lekki,mobolaji johnson estate lekki phase 1 lekki lagos,9,5,4,5,0,0,0,1,9,3500000
1441,lekki,chevron drive chevron lekki lagos,9,5,4,5,0,0,0,1,9,3500000
1442,lekki,ologolo lekki lagos,10,5,5,5,0,0,0,1,9,3500000
1443,lekki,lekki lekki phase 1 lekki lagos,7,4,3,4,1,1,1,1,7,4300000
1444,lekki,chevron lekki lagos,11,6,5,6,0,0,0,0,10,4700000
1445,lekki,chevron lekki lagos,7,4,3,4,0,0,0,0,7,2000000
1446,lekki,osapa osapa london lekki lagos,3,1,2,1,1,1,1,1,4,2000000
1447,lekki,off freedom way ikate lekki lagos,2,1,1,1,0,0,0,0,4,700000
1448,lekki,chevron lekki lagos,10,5,5,5,0,0,0,1,9,3500000
1449,lekki,chevron lekki lagos,9,5,4,5,0,0,0,1,9,3500000
1450,lekki,osapa london lekki lagos,7,4,3,4,0,0,0,0,7,2000000
1451,lekki,megamounds estates ikota lekki lagos,11,6,5,6,0,0,0,0,10,5000000
1452,lekki,lekki phase 1 lekki lagos,9,5,4,5,1,0,0,1,9,4000000
1453,lekki,chevron lekki lagos,8,4,4,4,0,0,0,0,7,2000000
1454,lekki,lekki phase 1 lekki lagos,7,4,3,4,1,1,1,1,7,4000000
1455,lekki,lekki phase 1 lekki lagos,10,5,5,5,0,0,0,1,9,3800000
1456,lekki,lekki phase 1 lekki lagos,5,3,2,3,1,1,0,1,7,2500000
1457,lekki,ikota lekki lagos,7,4,3,4,0,0,0,1,7,2500000
1458,lekki,chevron lekki lagos,12,6,6,6,0,0,0,0,10,4700000
1459,lekki,chevron drive chevron lekki lagos,7,4,3,4,0,0,0,1,7,2500000
1460,lekki,lekki lekki phase 1 lekki lagos,13,7,6,7,0,0,0,1,10,6000000
1461,lekki,lekki phase 1 lekki lagos,9,5,4,5,1,1,1,1,9,5600000
1462,lekki,ikota villa estates ikota lekki lagos,9,5,4,5,0,0,0,1,9,3500000
1463,lekki,pinnock estate jakande lekki lagos,13,7,6,7,0,0,0,1,10,6500000
1464,lekki,ikate ikate lekki lagos,7,4,3,4,1,0,0,1,7,3000000
1465,lekki,osapa london lekki lagos,9,5,4,5,0,0,0,1,9,3500000
1466,lekki,located in lekki county homes ikota lekki lagos nigeria ikota lekki lagos,11,6,5,6,1,1,0,1,10,6200000
1467,lekki,osapa london lekki lagos,10,5,5,5,0,0,0,1,9,3500000
1468,lekki,"admiralty way,lekki phase one lekki phase 1 lekki lagos",5,3,2,3,1,1,1,1,7,3500000
1469,lekki,lekki phase 1 lekki lagos,13,7,6,7,0,0,0,1,10,6000000
1470,lekki,chevron lekki lagos,10,5,5,5,0,0,0,1,9,3500000
1471,lekki,osapa osapa london lekki lagos,5,3,2,3,0,0,0,1,7,2000000
1472,lekki,osapa osapa london lekki lagos,5,3,2,3,0,0,0,1,7,2000000
1473,lekki,chevron lekki lagos,11,6,5,6,0,0,0,0,10,4700000
1474,lekki,lekki phase 1 lekki lagos,7,4,3,4,0,0,0,1,7,2800000
1475,lekki,chevron lekki lagos,8,4,4,4,0,0,0,0,7,2000000
1476,lekki,chevron drive chevron lekki lagos,9,5,4,5,0,0,0,1,9,3500000
1477,lekki,lekki county estate ikota lekki lagos,6,3,3,3,0,0,0,0,7,1600000
1478,lekki,lekki phase 1 lekki lagos,13,7,6,7,0,0,0,0,10,5500000
1479,lekki,ikate lekki lagos,8,4,4,4,0,0,0,1,7,2700000
1480,lekki,lekki phase 1 lekki lagos,7,4,3,4,1,1,1,1,7,4300000
1481,lekki,chevron chevron lekki lagos,9,5,4,5,0,0,0,1,9,3500000
1482,lekki,chevron alternative route lekki phase 1 lekki lagos,11,6,5,6,1,1,0,1,10,6200000
1483,lekki,ikota ikota lekki lagos,9,5,4,5,1,0,0,1,9,4000000
1484,lekki,chevron lekki lagos,10,5,5,5,0,0,0,1,9,3500000
1485,lekki,orchid road ikota lekki lagos,9,5,4,5,0,0,0,1,9,3500000
1486,lekki,chevron lekki lagos,12,6,6,6,0,0,0,0,10,4700000
1487,lekki,marwa lekki phase 1 lekki lagos,9,5,4,5,1,0,1,1,9,4500000
1488,lekki,lekki phase 1 lekki lagos,7,4,3,4,1,1,1,1,7,4300000
1489,lekki,lekki phase 1 lekki lagos,11,6,5,6,0,0,0,1,10,6000000
1490,lekki,chevron drive chevron lekki lagos,7,4,3,4,0,0,0,0,7,2300000
1491,lekki,idado lekki lagos,9,5,4,5,0,0,0,1,9,3500000
1492,lekki,eputu ibeju lekki lagos,2,1,1,1,0,0,0,0,4,455000
1493,lekki,beside prime waters ikate lekki lagos,2,1,1,1,0,0,0,1,4,815000
1494,lekki,located at west end estate off lekki county estate ikota lekki lagos,9,5,4,5,0,0,0,1,9,3500000
1495,lekki,safe court apartments lekki phase 1 lekki lagos,7,4,3,4,1,0,0,1,7,3000000
1496,lekki,lekki phase 1 lekki lagos,10,5,5,5,1,1,1,1,9,5000000
1497,lekki,femi okunu estate lekki phase 1 lekki lagos,10,5,5,5,0,0,0,1,9,3500000
1498,lekki,lekki phase 1 lekki lagos,7,4,3,4,1,1,1,1,7,3500000
1499,lekki,lekki phase 1 lekki lagos,4,2,2,2,0,0,0,1,6,1500000
1500,lekki,lekki phase 1 lekki lagos,6,3,3,3,0,0,0,1,7,2000000
1501,lekki,lekki phase 1 lekki phase 1 lekki lagos,12,6,6,6,1,1,0,1,10,6200000
1502,lekki,idado lekki lagos,9,5,4,5,1,0,0,1,9,4000000
1503,lekki,lekki lagos,4,2,2,2,0,0,0,0,6,900000
1504,lekki,lekki lagos,4,2,2,2,0,0,0,0,6,900000
1505,lekki,located at chisco at ikate lekki inside an estate ikate lekki lagos,7,4,3,4,1,1,1,1,7,3500000
1506,lekki,osapa london lekki lagos,8,4,4,4,0,0,0,0,7,2200000
1507,lekki,lekki lagos,6,3,3,3,1,1,1,1,7,3000000
1508,lekki,lekki lagos,16,8,8,8,1,1,0,1,10,7000000
1509,lekki,lekki lagos,10,5,5,5,1,1,1,1,9,5600000
1510,lekki,"ikota villa, behind mega chicken, lekki phase 2 lekki lagos",9,5,4,5,0,0,0,1,9,3500000
1511,lekki," chevron, lekki, lagos chevron lekki lagos",8,4,4,4,0,0,0,0,7,2000000
1512,lekki," chevron, lekki lagos chevron lekki lagos",9,4,5,4,0,0,0,0,7,2000000
1513,lekki,value county estate near lagos business school off lekki epe expressway ajah lagos,8,4,4,4,0,0,0,0,7,2000000
1514,lekki,lekki lagos,10,5,5,5,1,0,0,1,9,4000000
1515,lekki,agungi lekki lagos,8,4,4,4,1,1,1,1,7,4000000
1516,lekki,ologolo lekki lagos,7,4,3,4,0,0,0,1,7,2500000
1517,lekki,osapa london lekki lagos,2,1,1,1,0,0,0,0,4,600000
1518,lekki,after lbs in olokonla in ajah axis lekki. olokonla ajah lagos,7,4,3,4,0,0,0,0,7,2000000
1519,lekki,opp ikota villa before ajah in lekki. lekki phase 2 lekki lagos,4,2,2,2,0,0,0,0,6,900000
1520,lekki,osapa london lekki lagos,6,3,3,3,0,0,0,0,7,1200000
1521,lekki,lekki phase 1 lekki lagos,7,4,3,4,0,0,0,0,7,2000000
1522,lekki,lekki phase 1 lekki lagos,2,1,1,1,0,0,0,0,4,700000
1523,lekki,chevron lekki lagos,6,3,3,3,0,0,0,1,7,2000000
1524,lekki,lekki phase 1 lekki phase 1 lekki lagos,2,1,1,1,0,0,0,1,4,1000000
1525,lekki,igbo efon igbo efon lekki lagos,2,1,1,1,0,0,0,0,4,450000
1526,lekki,lekki lagos,8,4,4,4,1,0,0,1,7,3000000
1527,lekki,lekki lagos,6,3,3,3,1,1,0,1,7,2500000
1528,lekki,ikota lekki lagos,2,1,1,1,0,0,0,0,4,400000
1529,lekki,lekki lagos,8,4,4,4,1,0,0,1,7,3000000
1530,lekki,lekki lagos,8,4,4,4,1,1,1,1,7,3500000
1531,lekki,lekki lagos,8,4,4,4,1,1,1,1,7,4300000
1532,lekki,lekki phase 1 lekki lagos,3,2,1,2,0,0,0,0,6,1200000
1533,lekki,lekki lagos,8,4,4,4,1,1,1,1,7,3500000
1534,lekki,lekki lagos,8,4,4,4,1,0,0,1,7,3000000
1535,lekki,lekki lagos,6,3,3,3,0,0,0,0,7,1000000
1536,lekki,osapa london osapa london lekki lagos,2,1,1,1,0,0,0,0,4,500000
1537,lekki,around blenco supermarket before sangotedo in ajah axis lekki. peninsula estate ajah lagos,3,2,1,2,0,0,0,0,6,900000
1538,lekki,after blenco supermarket before sangotedo market in ajah axis lekki. sangotedo ajah lagos,7,4,3,4,0,0,0,0,7,2000000
1539,lekki,fidiso estate in kingdom hall road in abijo in ajah axis lekki. abijo ajah lagos,2,1,1,1,0,0,0,0,4,400000
1540,lekki,after blenco supermarket before sangotedo market in ajah axis lekki. sangotedo ajah lagos,9,5,4,5,0,0,0,1,9,3500000
1541,lekki,majek sangotedo in ajah axis lekki. sangotedo ajah lagos,3,2,1,2,0,0,0,0,6,900000
1542,lekki,opp sangotedo market in ajah axis lekki. sangotedo ajah lagos,5,3,2,3,0,0,0,0,7,1000000
1543,lekki,opp sangotedo market in ajah axis lekki. sangotedo ajah lagos,7,4,3,4,0,0,0,0,7,2000000
1544,lekki,orchid hotel road lekki phase 2 lekki lagos,10,5,5,5,1,0,0,1,9,4000000
1545,lekki,orchid hotel road. lekki phase 2 lekki lagos,10,5,5,5,0,0,0,1,9,3500000
1546,lekki,18 ihuntayi street off palace road oniru estate lekki phase 1 lekki lagos,6,3,3,3,1,1,1,1,7,3000000
1547,lekki,bera estate chevron lekki lagos,10,5,5,5,1,1,1,1,9,5000000
1548,lekki,lekki lagos,4,2,2,2,1,1,1,1,6,2000000
1549,lekki,innocent street igbo efon igbo efon lekki lagos,2,1,1,1,0,0,0,0,4,450000
1550,lekki,igbo efon igbo efon lekki lagos,2,1,1,1,0,0,0,0,4,400000
1551,lekki,abraham adesanya estate ajah lagos,4,2,2,2,0,0,0,0,6,900000
1552,lekki,villa estate ikota lekki lagos,6,3,3,3,0,0,0,1,7,2000000
1553,lekki,lekki garden estate phase 4 lekki gardens estate ajah lagos,9,5,4,5,0,0,0,1,9,3500000
1554,lekki," megamound estate by lekki county estate, ikota lekki lagos",11,6,5,6,0,0,0,0,10,4700000
1555,lekki,behind the new shoprite in sangotedo in ajah axis lekki. sangotedo ajah lagos,10,5,5,5,0,0,0,1,9,3500000
1556,lekki,lekki phase 1 lekki phase 1 lekki lagos,10,5,5,5,1,1,1,1,9,5600000
1557,lekki,idado estate idado lekki lagos,7,4,3,4,0,0,0,1,7,2500000
1558,lekki," behind cooplag garden, on orchid road ikota lekki lagos",6,3,3,3,0,0,0,0,7,1000000
1559,lekki,beside french colony estate off agungi - ajiran road lekki agungi lekki lagos,5,3,2,3,0,0,0,1,7,2000000
1560,lekki,ik ikate lekki lagos,8,4,4,4,1,1,1,1,7,3500000
1561,lekki,ikate elegushi ikate lekki lagos,9,5,4,5,0,0,0,1,9,3500000
1562,lekki,jakande 1st gate jakande lekki lagos,7,4,3,4,0,0,0,1,7,2500000
1563,lekki,behind nigel office lekki phase 1 lekki lagos,10,5,5,5,1,1,1,1,9,5000000
1564,lekki," ikate elegushi, ikate lekki lagos",8,4,4,4,0,0,0,0,7,2000000
1565,lekki,ikate lekki lagos,6,3,3,3,0,0,0,1,7,2200000
1566,lekki,chevy view estate chevron lekki lagos,7,4,3,4,0,0,0,0,7,2000000
1567,lekki,"bera estate, chevron. lekki phase 1 lekki lagos",9,5,4,5,0,0,0,1,9,3500000
1568,lekki,ikate lekki lagos,10,5,5,5,1,1,1,1,9,5600000
1569,lekki,lekki palm city estate off lekki epe expressway ajah lagos,7,4,3,4,0,0,0,0,7,2000000
1570,lekki,freedom way lekki phase 1 ikoyi lagos,10,5,5,5,1,1,1,1,9,5600000
1571,lekki," ikate lekki lagos, ikate lekki lagos",8,4,4,4,1,1,1,1,7,4300000
1572,lekki,ologolo ologolo lekki lagos,5,3,2,3,0,0,0,0,7,1700000
1573,lekki,lekki lagos,2,1,1,1,1,1,1,1,4,1600000
1574,lekki,ikate lekki lagos ikate lekki lagos,9,5,4,5,0,0,0,1,9,3500000
1575,lekki,kusenla road ikate lekki lagos,7,4,3,4,1,0,0,1,7,3000000
1576,lekki,lekki lagos,2,1,1,1,1,1,1,1,4,1300000
1577,lekki,lekki phase1 lekki phase 1 lekki lagos,7,4,3,4,0,0,0,1,7,2500000
1578,lekki,ikota villa estate ikota lekki lagos,7,4,3,4,0,0,0,0,7,2000000
1579,lekki,"off babatunde anjouse street, lekki phase 1 lekki lagos",5,3,2,3,1,1,0,1,7,2500000
1580,lekki,lekki phase1 lekki phase 1 lekki lagos,5,3,2,3,1,1,1,1,7,3500000
1581,lekki,oral estate lekki lagos,8,4,4,4,1,1,1,1,7,4300000
1582,lekki,ikate lekki lagos,5,3,2,3,0,0,0,1,7,2000000
1583,lekki," ikate elegushi, ikate lekki lagos",7,4,3,4,0,0,0,0,7,2000000
1584,lekki,lekki phase1 lekki phase 1 lekki lagos,7,4,3,4,1,1,1,1,7,4300000
1585,lekki," ogunfayo mini estate awoyaya, awoyaya ibeju lekki lagos",10,5,5,5,0,0,0,1,9,3500000
1586,lekki,jakande lekki lagos,8,4,4,4,1,1,1,1,7,3800000
1587,lekki,lekki lagos,8,4,4,4,0,0,0,1,7,2700000
1588,lekki,osapa london lekki lagos,9,5,4,5,1,1,1,1,9,5000000
1589,lekki,osapa osapa london lekki lagos,9,5,4,5,0,0,0,1,9,3600000
1590,lekki,chevron lekki lagos,8,4,4,4,1,1,1,1,7,3500000
1591,lekki,chevron lekki lagos,8,4,4,4,1,1,1,1,7,3500000
1592,lekki,osapa osapa london lekki lagos,10,5,5,5,0,0,0,1,9,3500000
1593,lekki,chevron lekki lagos,9,5,4,5,0,0,0,1,9,3500000
1594,lekki," ikota villa estate, ikota lekki lagos",11,5,6,5,1,1,1,1,9,5600000
1595,lekki,lekki phase 1 lekki lagos,10,5,5,5,1,1,1,1,9,5600000
1596,lekki,ikota villa gra ikota lekki lagos,5,3,2,3,0,0,0,0,7,1500000
1597,lekki,majek opp fara park after crown estate in sangotedo in ajah axis lekki. crown estate ajah lagos,8,4,4,4,0,0,0,0,7,2000000
1598,lekki,bera chevron lekki lagos,8,4,4,4,0,0,0,0,7,2000000
1599,lekki,dr alakija lekki phase 1 lekki lagos,8,4,4,4,1,0,0,1,7,3000000
1600,lekki,alternative route chevron lekki lagos,9,5,4,5,0,0,0,1,9,3500000
1601,lekki,ologolo ologolo lekki lagos,3,2,1,2,0,0,0,0,6,1000000
1602,lekki,ikate lekki lagos,9,5,4,5,1,0,1,1,9,4500000
1603,lekki,bera estate chevron lekki lagos,7,4,3,4,0,0,0,0,7,2000000
1604,lekki,lekki palms estate lavalon hotel estate off addo road ajah ado ajah lagos,9,5,4,5,0,0,0,1,9,3500000
1605,lekki,lekki lagos,4,2,2,2,1,1,1,1,6,2000000
1606,lekki,agungi road lekki lagos,2,1,1,1,0,0,0,1,4,800000
1607,lekki,southern view estate beside lekki conservation center opp chevron lekki peninsula lekki chevron lekki lagos,2,1,1,1,0,0,0,1,4,900000
1608,lekki,chevy view lekki lagos,11,6,5,6,0,0,0,0,10,4700000
1609,lekki,chevron drive chevron lekki lagos,7,4,3,4,0,0,0,0,7,2400000
1610,lekki,lekki lagos,10,5,5,5,1,1,1,1,9,5600000
1611,lekki,salem lekki phase 1 lekki lagos,7,4,3,4,0,0,0,0,7,2000000
1612,lekki,off castle and temple off admiralty road lekki phase 1 lekki lagos,7,4,3,4,1,1,1,1,7,4300000
1613,lekki,off road 14 lekki phase 1 lekki lagos,7,4,3,4,1,0,0,1,7,3000000
1614,lekki,ikate lekki lagos,10,5,5,5,1,1,1,1,9,5600000
1615,lekki,chevron lekki lagos,8,4,4,4,1,1,1,1,7,3500000
1616,lekki,lekki lagos,4,2,2,2,1,1,1,1,6,2000000
1617,lekki," around crown estate, sangotedo, ajah axis, lekki. sangotedo ajah lagos",6,3,3,3,0,0,0,0,7,1000000
1618,lekki," not far from pinnock beach estate, jakande, lekki osapa london lekki lagos",6,3,3,3,1,1,0,1,7,2500000
1619,lekki,oral estate lekki lagos,10,5,5,5,1,0,1,1,9,4500000
1620,lekki,estate osapa london lekki lagos,2,1,1,1,0,0,0,1,4,850000
1621,lekki,osapa osapa london lekki lagos,2,1,1,1,1,0,0,1,4,1200000
1622,lekki,ikate elegushi ikate lekki lagos,5,3,2,3,0,0,0,1,7,2000000
1623,lekki,lekki phase 2 lekki phase 2 lekki lagos,9,5,4,5,0,0,0,1,9,3500000
1624,lekki,chevy view estate chevron lekki lagos,11,6,5,6,0,0,0,0,10,5000000
1625,lekki,lekki paradise estate chevron lekki lagos,9,5,4,5,1,1,1,1,9,5000000
1626,lekki,osapa london lekki lagos,12,6,6,6,1,1,0,1,10,6200000
1627,lekki," ikate elegushi, ikate lekki lagos",6,3,3,3,1,1,1,1,7,3000000
1628,lekki,ikate lekki lagos ikate lekki lagos,5,3,2,3,1,1,0,1,7,2500000
1629,lekki,osapa osapa london lekki lagos,2,1,1,1,0,0,0,0,4,600000
1630,lekki,lekki phase 1 lekki lagos,10,5,5,5,1,1,1,1,9,5600000
1631,lekki,chevron lekki lagos,9,5,4,5,1,0,1,1,9,4500000
1632,lekki,"off freedom way, lekki phase 1 lekki phase 1 lekki lagos",3,2,1,2,0,0,0,0,6,1400000
1633,lekki,ikota villa estate ikota lekki lagos,7,4,3,4,0,0,0,0,7,2000000
1634,lekki,5 street estate osapa london lekki lagos,2,1,1,1,0,0,0,0,4,400000
1635,lekki,osapa london osapa london lekki lagos,5,3,2,3,0,0,0,0,7,1800000
1636,lekki,agungi agungi lekki lagos,7,4,3,4,0,0,0,1,7,2500000
1637,lekki,chevy view estate chevron lekki lagos,7,4,3,4,0,0,0,0,7,2200000
1638,lekki,igbo efon by eti osa lg igbo efon lekki lagos,5,3,2,3,0,0,0,0,7,1000000
1639,lekki,lekki lagos,8,4,4,4,1,1,1,1,7,3500000
1640,lekki,osapa london osapa london lekki lagos,2,1,1,1,0,0,0,1,4,1100000
1641,lekki,lekki ph1 estate lagos. lekki phase 1 lekki lagos,7,4,3,4,1,1,1,1,7,4300000
1642,lekki,osapa london lekki lagos,6,3,3,3,0,0,0,1,7,2000000
1643,lekki,oceanestate ologolo lekki lagos,8,4,4,4,0,0,0,0,7,2000000
1644,lekki,ocean breeze ologolo lekki lagos,10,5,5,5,0,0,0,1,9,3500000
1645,lekki,agungi agungi lekki lagos,3,1,2,1,1,1,1,1,4,2000000
1646,lekki,lekki lagos,2,1,1,1,1,1,1,1,4,1600000
1647,lekki,before blenco supermarket in olokonla in ajah axis lekki. olokonla ajah lagos,10,5,5,5,0,0,0,1,9,3500000
1648,lekki," ikate elegushi, lekki lagos",2,1,1,1,0,0,0,0,4,500000
1649,lekki,before sangotedo market in sangotedo in ajah axis lekki. sangotedo ajah lagos,6,3,3,3,0,0,0,0,7,1000000
1650,lekki,off kusenla ikate lekki lagos,9,5,4,5,0,0,0,1,9,3500000
1651,lekki,off admiralty road lekki phase 1 lekki lagos,8,4,4,4,1,1,1,1,7,4300000
1652,lekki,by mobolaji johnson lekki phase 1 lekki lagos,7,4,3,4,1,1,1,1,7,3500000
1653,lekki,around the new shoprite in sangotedo in ajah axis lekki. sangotedo ajah lagos,10,5,5,5,0,0,0,1,9,3500000
1654,lekki,. ologolo lekki lagos,7,4,3,4,1,0,0,1,7,3200000
1655,lekki,lekki phase 1 lekki lagos,2,1,1,1,1,1,1,1,4,1500000
1656,lekki,close to the spar ikate lekki lagos,8,4,4,4,1,0,0,1,7,3000000
1657,lekki,lekki right lekki phase 1 lekki lagos,7,4,3,4,1,1,1,1,7,3800000
1658,lekki,ikota lekki lagos,8,4,4,4,1,0,0,1,7,3000000
1659,lekki,ikota ikota lekki lagos,8,4,4,4,1,1,1,1,7,3500000
1660,lekki,lekki phase 1 lekki lagos,8,5,3,5,0,0,0,1,9,3500000
1661,lekki,"oladimeji alo street, lekki phase 1 lekki lagos",11,6,5,6,0,0,0,0,10,5000000
1662,lekki,off kazim osapa london lekki lagos,6,3,3,3,0,0,0,1,7,2000000
1663,lekki,- osapa london lekki lagos,2,1,1,1,0,0,0,0,4,500000
1664,lekki,lekki lekki phase 1 lekki lagos,8,4,4,4,0,0,0,1,7,2500000
1665,lekki,lekki phase one lekki phase 1 lekki lagos,5,3,2,3,1,1,1,1,7,3000000
1666,lekki,agungi lekki lagos,6,3,3,3,0,0,0,0,7,1800000
1667,lekki," idado, lekki idado lekki lagos",5,3,2,3,0,0,0,0,7,1500000
1668,lekki,fubara green igbo efon lekki lagos,4,2,2,2,0,0,0,0,6,1200000
1669,lekki,ikate ikate lekki lagos,11,6,5,6,0,0,0,1,10,6000000
1670,lekki," valley stream estate, osapa london lekki lagos",9,5,4,5,0,0,0,1,9,3500000
1671,lekki,.. idado lekki lagos,2,1,1,1,0,0,0,1,4,1000000
1672,lekki,lekki paradise chevron lekki lagos,8,4,4,4,1,0,0,1,7,3000000
1673,lekki,agungi agungi lekki lagos,2,1,1,1,0,0,0,0,4,450000
1674,lekki," lekki palm city estate, off ado road, ajah, lagos. badore ajah lagos",9,5,4,5,0,0,0,1,9,3500000
1675,lekki,off chevron drive chevron lekki lagos,7,4,3,4,1,0,0,1,7,3000000
1676,lekki,chevron drive chevron lekki lagos,7,4,3,4,1,1,1,1,7,3500000
1677,lekki,lekki phase 1 lekki lagos,6,3,3,3,1,1,1,1,7,3000000
1678,lekki,lekki lagos,2,1,1,1,1,1,1,1,4,1700000
1679,lekki,off admiralty road lekki phase 1 lekki lagos,9,5,4,5,1,1,1,1,9,5600000
1680,lekki,agungi lekki lagos,6,3,3,3,0,0,0,0,7,1800000
1681,lekki,osapa london lekki lagos,9,5,4,5,0,0,0,1,9,3500000
1682,lekki,lafiaji road ikota lekki lagos,9,5,4,5,0,0,0,1,9,3500000
1683,lekki,. lekki lagos,6,3,3,3,0,0,0,1,7,2000000
1684,lekki,lekki county ikota lekki lagos,8,4,4,4,1,1,1,1,7,4300000
1685,lekki,lekki phase 2 lekki phase 2 lekki lagos,9,5,4,5,0,0,0,1,9,3500000
1686,lekki,osapa london lekki lagos,11,6,5,6,0,0,0,0,10,4700000
1687,lekki," ikate elegushi, ikate lekki lagos",2,1,1,1,0,0,0,0,4,400000
1688,lekki,vgc lekki lagos,12,7,5,7,0,0,0,0,10,5500000
1689,lekki,fola osibo. lekki phase 1 lekki lagos,13,7,6,7,1,1,0,1,10,6800000
1690,lekki,fatai arobike lekki phase 1 lekki lagos,2,1,1,1,1,1,1,1,4,1500000
1691,lekki,ikate lekki lagos,8,4,4,4,1,0,0,1,7,3000000
1692,lekki,elegushi ikate lekki lagos,10,5,5,5,0,0,0,1,9,3500000
1693,lekki,off admiralty road lekki phase 1 lekki lagos,9,5,4,5,1,1,1,1,9,5600000
1694,lekki,lekki phase 1 lekki phase 1 lekki lagos,2,1,1,1,1,1,1,1,4,1600000
1695,lekki,osapa osapa london lekki lagos,2,1,1,1,0,0,0,0,4,600000
1696,lekki," majek after fara park, after crown estate in ajah axis lekki. crown estate ajah lagos",6,3,3,3,0,0,0,0,7,1000000
1697,lekki,lbs lekki phase 2 lekki lagos,8,4,4,4,0,0,0,0,7,2000000
1698,lekki,ikate lekki lagos,7,4,3,4,0,0,0,0,7,2300000
1699,lekki,lekki lagos,4,2,2,2,1,1,1,1,6,2000000
1700,lekki,ilasan lekki lagos,7,4,3,4,0,0,0,0,7,2000000
1701,lekki,lekki phase 2 lekki lagos,2,1,1,1,0,0,0,0,4,650000
1702,lekki,fola osibo lekki phase 1 lekki lagos,13,7,6,7,1,1,0,1,10,6800000
1703,lekki,close to the spar ikate lekki lagos,8,4,4,4,1,0,0,1,7,3000000
1704,lekki,agungi lekki lagos,2,1,1,1,0,0,0,1,4,1000000
1705,lekki,megamound estate ikota lekki lagos,9,5,4,5,1,1,1,1,9,5600000
1706,lekki,orchid road ikota lekki lagos,8,4,4,4,1,0,0,1,7,3000000
1707,lekki,osapa osapa london lekki lagos,7,4,3,4,0,0,0,0,7,2000000
1708,lekki,osapa osapa london lekki lagos,11,6,5,6,1,1,0,1,10,6200000
1709,lekki,chevron chevron lekki lagos,9,5,4,5,0,0,0,1,9,3500000
1710,lekki," ikate elegushi, ikate lekki lagos",7,4,3,4,0,0,0,1,7,2500000
1711,lekki,igbo efon lekki lagos,7,4,3,4,0,0,0,0,7,2000000
1712,lekki,lekki paradise 3 estate chevron lekki lagos,7,4,3,4,0,0,0,1,7,2500000
1713,lekki,ikota villa estate ikota lekki ikota lekki lagos,2,1,1,1,0,0,0,0,4,500000
1714,lekki,lekki lagos lekki phase 1 lekki lagos,8,4,4,4,0,0,0,1,7,2800000
1715,lekki," united estate, sangotedo, ajah axis, lekki. sangotedo ajah lagos",4,2,2,2,0,0,0,0,6,900000
1716,lekki,off osapa agungi lekki lagos,2,1,1,1,0,0,0,1,4,850000
1717,lekki,orchid road ikota lekki lagos,8,4,4,4,1,0,0,1,7,3000000
1718,lekki," majek, opposite fara park, in ajah axis lekki. crown estate ajah lagos",4,2,2,2,0,0,0,0,6,900000
1719,lekki," megamound avenue, ikota villa estate lekki lagos",11,6,5,6,0,0,0,0,10,4700000
1720,lekki,ibeju lekki lagos,2,1,1,1,0,0,0,0,4,400000
1721,lekki,. lekki phase 1 lekki lagos,8,4,4,4,0,0,0,1,7,2500000
1722,lekki,osapa london lekki lagos,6,3,3,3,0,0,0,0,7,1500000
1723,lekki,ikate lekki lagos,10,5,5,5,1,1,1,1,9,5600000
1724,lekki,victory park osapa london lekki lagos,12,6,6,6,1,1,0,1,10,6200000
1725,lekki,lekki phase 1 lekki phase 1 lekki lagos,7,4,3,4,1,1,1,1,7,4000000
1726,lekki,yeye olofin street lekki phase 1 lekki lagos,4,2,2,2,1,0,0,1,6,1700000
1727,lekki,ikate lekki lagos,4,2,2,2,1,1,1,1,6,3000000
1728,lekki,ikate lekki lagos,8,4,4,4,1,1,1,1,7,4300000
1729,lekki,osapa osapa london lekki lagos,2,1,1,1,0,0,0,1,4,800000
1730,lekki,spg road ologolo lekki lagos,2,1,1,1,1,0,0,1,4,1200000
1731,lekki,idado estate lekki lagos idado lekki lagos,7,4,3,4,0,0,0,0,7,2000000
1732,lekki,osapa osapa london lekki lagos,2,1,1,1,0,0,0,0,4,500000
1733,lekki," estate, agungi lekki lagos",2,1,1,1,0,0,0,0,4,400000
1734,lekki,idado idado lekki lagos,7,4,3,4,0,0,0,0,7,2000000
1735,lekki,before blenco supermarket in olokonla in ajah axis lekki. olokonla ajah lagos,6,3,3,3,0,0,0,0,7,1000000
1736,lekki,ikate lekki lagos,8,4,4,4,1,0,0,1,7,3000000
1737,lekki,ologolo road ologolo lekki lagos,7,4,3,4,0,0,0,1,7,2500000
1738,lekki,off admiralty lekki phase 1 lekki lagos,7,4,3,4,0,0,0,0,7,2200000
1739,lekki,orchid road lekki lagos,9,5,4,5,1,0,0,1,9,4000000
1740,lekki," idado ext., agungi lekki lagos",2,1,1,1,0,0,0,0,4,400000
1741,lekki,.. idado lekki lagos,2,1,1,1,0,0,0,1,4,900000
1742,lekki,.. idado lekki lagos,2,1,1,1,0,0,0,0,4,700000
1743,lekki," ikota gra, ikota villa ikota lekki lagos",5,3,2,3,0,0,0,0,7,1700000
1744,lekki,shoprite road osapa london lekki lagos,3,2,1,2,0,0,0,1,6,1500000
1745,lekki,atlantic view estate alpha beach road lekki lagos,2,1,1,1,0,0,0,0,4,500000
1746,lekki,lekki scheme 2 abraham adesanya ogombo road ajah ogombo ajah lagos,5,3,2,3,0,0,0,0,7,1000000
1747,lekki,agungi lekki lagos,2,1,1,1,0,0,0,1,4,850000
1748,lekki,southern view estate ikota lekki lagos,3,2,1,2,0,0,0,0,6,900000
1749,lekki,lekki scheme 2 abraham adesanya ogombo road ajah ilaje ajah lagos,7,4,3,4,0,0,0,0,7,2000000
1750,lekki,off ayo babatunde street oniru lekki phase 1 lekki lagos,7,4,3,4,1,0,0,1,7,3000000
1751,lekki,osapa london lekki lagos,7,4,3,4,0,0,0,0,7,2000000
1752,lekki," oceanbay estate, lafiaji chevron lekki lagos",7,4,3,4,1,1,1,1,7,4000000
1753,lekki,eleganza gardens vgc lekki lagos,7,4,3,4,0,0,0,0,7,2000000
1754,lekki,12e admiralty way opposite skybox lekki phase 1 lekki lagos,2,1,1,1,1,1,1,1,4,1300000
1755,lekki,12e admiralty way opposite skybox lekki phase 1 lekki lagos,2,1,1,1,0,0,0,1,4,1000000
1756,lekki,chevron lekki lagos,10,5,5,5,1,0,0,1,9,4000000
1757,lekki,chevron lekki lagos,10,5,5,5,1,0,0,1,9,4000000
1758,lekki,hi lekki phase 1 lekki lagos,2,1,1,1,1,1,1,1,4,1500000
1759,lekki,h lekki phase 1 lekki lagos,2,1,1,1,1,1,1,1,4,1400000
1760,lekki,lekki phase 1 lekki lagos,11,6,5,6,0,0,0,1,10,6000000
1761,lekki,lekki phase 1 lekki lagos,9,5,4,5,1,1,1,1,9,5600000
1762,lekki,lekki phase 1 lekki phase 1 lekki lagos,15,8,7,8,1,1,0,1,10,7000000
1763,lekki,off platinum way lekki phase 2 lekki phase 2 lekki lagos,9,5,4,5,0,0,0,1,9,3500000
1764,lekki,chervon alternative road lekki lagos. chevron lekki lagos,12,6,6,6,1,1,0,1,10,6200000
1765,lekki," safe court estate ikate,elegushi lekki. ikate lekki lagos",7,4,3,4,1,0,0,1,7,3000000
1766,lekki," safe court estate ikate, elegushi lekki, ikate lekki lagos",7,4,3,4,1,0,0,1,7,3000000
1767,lekki,horizon 11 estate via meadow hall way. ikate lekki lagos,7,4,3,4,0,0,0,1,7,2750000
1768,lekki," lekki palm city estate, opposite ecobank ado road ajah lagos ado ajah lagos",5,3,2,3,0,0,0,0,7,1400000
1769,lekki,off orchid hotel road chevron lekki lagos,9,5,4,5,0,0,0,1,9,3500000
1770,lekki,34 agungi road agungi lekki lagos,5,2,3,2,1,1,1,1,6,3000000
1771,lekki,chief collins lekki phase 1 lekki lagos,3,1,2,1,1,0,0,1,4,1200000
1772,lekki,oba amusa adebambo avenue agungi lekki lagos,2,1,1,1,0,0,0,0,4,400000
1773,lekki,"25, ganiu eletu, street awoyaya eputu ibeju lekki lagos",4,2,2,2,0,0,0,0,6,900000
1774,lekki,idado estate idado lekki lagos,5,3,2,3,1,1,0,1,7,2500000
1775,lekki,ikate ikate lekki lagos,5,3,2,3,0,0,0,1,7,2000000
1776,lekki," shoprite road, osapa london lekki lagos",2,1,1,1,0,0,0,0,4,750000
1777,lekki,lekki phase 1 lekki phase 1 lekki lagos,2,1,1,1,0,0,0,1,4,1000000
1778,lekki," idado ext., idado lekki lagos",2,1,1,1,0,0,0,0,4,700000
1779,lekki,.. igbo efon lekki lagos,2,1,1,1,0,0,0,0,4,400000
1780,lekki,shoprite road osapa london lekki lagos,5,3,2,3,0,0,0,1,7,2000000
1781,lekki,- igbo efon lekki lagos,3,2,1,2,0,0,0,0,6,900000
1782,lekki,megamound estate lekki country homes ikota ikota lekki lagos,11,6,5,6,0,0,0,0,10,4700000
1783,lekki,2nd avenue lekki phase 1 lekki lagos,6,3,3,3,0,0,0,0,7,1800000
1784,lekki,2 avenue lekki phase 1 lekki lagos,8,4,4,4,0,0,0,0,7,2000000
1785,lekki,.. ologolo lekki lagos,6,3,3,3,0,0,0,0,7,1500000
1786,lekki,horizon 11 estate via meadow hall way ikate elegushi. ikate lekki lagos,7,4,3,4,0,0,0,1,7,2750000
1787,lekki,lekki phase 1 lekki lagos,5,3,2,3,1,1,1,1,7,2800000
1788,lekki,lekki phase 1 lekki lagos,11,6,5,6,0,0,0,1,10,6000000
1789,lekki,prince olanrewaju elegushi street ikate lekki lagos,5,3,2,3,0,0,0,0,7,1000000
1790,lekki,chevron lekki phase 1 lekki lagos,2,1,1,1,0,0,0,1,4,800000
1791,lekki," ikate elegushi, lekki lagos",2,1,1,1,0,0,0,1,4,800000
1792,lekki,no 7 bello close chevy view estate chevron lekki lagos,12,6,6,6,0,0,0,0,10,5000000
1793,lekki,chevron lekki lagos,2,1,1,1,1,1,1,1,4,1500000
1794,lekki,chevron lekki lagos,5,3,2,3,0,0,0,1,7,2000000
1795,lekki," after forte oil before abraham adesanya roundabout, lekki expressway lekki lagos",2,1,1,1,0,0,0,0,4,400000
1796,lekki,lekki phase 1 lekki lagos,4,2,2,2,0,0,0,0,6,1200000
1797,lekki," main elesekan town road, bogije ibeju lekki lagos",7,4,3,4,0,0,0,0,7,2000000
1798,lekki," victoria bay estate, lafiaji lekki lagos",5,3,2,3,1,1,0,1,7,2500000
1799,lekki," victoria bay estate, lafiaji lekki lagos",7,4,3,4,0,0,0,1,7,2900000
1800,lekki," ibrahim odo close, by friend colony gate, off agungi road agungi lekki lagos",9,5,4,5,0,0,0,1,9,3500000
1801,lekki,lekki phase 1 lekki lagos,2,1,1,1,1,1,1,1,4,1900000
1802,lekki,lekki phase 1 lekki phase 1 lekki lagos,4,2,2,2,0,0,0,0,6,1200000
1803,lekki,agungi agungi lekki lagos,5,3,2,3,0,0,0,0,7,1800000
1804,lekki,meadow hall way ikate lekki lagos,2,1,1,1,0,0,0,1,4,1000000
1805,lekki," rdp apartments, beechwood park estate, lekki express way ibeju- lekki eleko ibeju lekki lagos",6,3,3,3,0,0,0,0,7,1000000
1806,lekki,palm spring road ikate lekki lagos,6,3,3,3,1,1,1,1,7,3500000
1807,lekki,by pinnacle filling station lekki phase 1 lekki lagos,11,6,5,6,1,1,0,1,10,6200000
1808,lekki,lake view estate orchid road estate lekki phase 1 lekki lagos,7,4,3,4,0,0,0,1,7,2500000
1809,lekki,bakare estate agungi lekki lagos,2,1,1,1,0,0,0,0,4,650000
1810,lekki,ologolo lekki lagos,9,5,4,5,0,0,0,1,9,3500000
1811,lekki,ikota ikota lekki lagos,9,5,4,5,0,0,0,1,9,3500000
1812,lekki,off fola osibo lekki phase 1 lekki lagos,7,4,3,4,0,0,0,1,7,2700000
1813,lekki," earls court, ikate elegushi ikate lekki lagos",10,5,5,5,1,1,1,1,9,5600000
1814,lekki,hakeem dickson lekki phase 1 lekki lagos,2,1,1,1,0,0,0,1,4,1000000
1815,lekki," chevron drive, chevron lekki lagos",2,1,1,1,0,0,0,0,4,600000
1816,lekki,lekki phase 1 lekki phase 1 lekki lagos,5,3,2,3,1,1,0,1,7,2500000
1817,lekki," ikate elegushi, ikate lekki lagos",2,1,1,1,1,1,1,1,4,2000000
1818,lekki,adiva estate ibeju lekki lagos,6,3,3,3,0,0,0,0,7,1000000
1819,lekki,adiva estate ibeju lekki lagos,6,3,3,3,0,0,0,0,7,1000000
1820,lekki,olanrewaju elegushi street ilasan lekki lagos,5,3,2,3,0,0,0,0,7,1000000
1821,lekki,ologolo lekki lagos,9,5,4,5,0,0,0,1,9,3500000
1822,lekki,ologolo lekki lagos,9,5,4,5,0,0,0,1,9,3500000
1823,lekki,located at ikota villa estate behind mega chicken ikota lekki lagos,9,5,4,5,0,0,0,1,9,3500000
1824,lekki," eric's place, behind spar on palm springs road ikate lekki lagos",7,4,3,4,1,1,1,1,7,4300000
1825,lekki,agungi agungi lekki lagos,4,2,2,2,0,0,0,0,6,1200000
1826,lekki," ikate elegushi, ikate lekki lagos",7,4,3,4,0,0,0,0,7,2300000
1827,lekki," lakowe lakes and country homes (golf resort), lakowe ibeju lekki lagos",9,5,4,5,0,0,0,1,9,3500000
1828,lekki,"off george enenmoh street, lekki phase 1 lekki lagos",2,1,1,1,0,0,0,1,4,1000000
1829,lekki," ikate elegushi, ikate lekki lagos",8,4,4,4,0,0,0,0,7,2000000
1830,lekki,lekki phase 1 lekki phase 1 lekki lagos,9,5,4,5,0,0,0,1,9,3500000
1831,lekki,ikota ikota lekki lagos,9,5,4,5,0,0,0,1,9,3500000
1832,lekki,off adekunle kuye adelabu lekki lagos,2,1,1,1,0,0,0,1,4,1000000
1833,lekki,"muri sodiq drive, off spg road, lekki lekki phase 1 lekki lagos",7,4,3,4,0,0,0,1,7,2800000
1834,lekki,prince kazeem eletu street osapa london osapa london lekki lagos,2,1,1,1,0,0,0,0,4,500000
1835,lekki,road 6 blook 56 chevron lekki lagos,2,1,1,1,0,0,0,0,4,650000
1836,lekki,okera-nla lekki ajah lagos ado ajah lagos,2,1,1,1,0,0,0,0,4,400000
1837,lekki,"ocean bay estate, lekki peninsula 2 lekki phase 2 lekki lagos",8,5,3,5,0,0,0,1,9,3500000
1838,lekki,agungi agungi lekki lagos,2,1,1,1,1,0,0,1,4,1200000
1839,lekki,"off oladimeji alo street, lekki phase 1 lekki lagos",2,1,1,1,0,0,0,0,4,600000
1840,lekki,"off oladimeji alo street, lekki phase 1 lekki lagos",2,1,1,1,0,0,0,0,4,600000
1841,lekki,orchid estate ologolo lekki lagos,2,1,1,1,0,0,0,0,4,400000
1842,lekki,lekki lekki phase 1 lekki lagos,2,1,1,1,0,0,0,0,4,400000
1843,lekki," ikota, lekki lekki lagos",5,3,2,3,0,0,0,0,7,1600000
1844,lekki,osapa osapa london lekki lagos,9,5,4,5,1,1,1,1,9,5000000
1845,lekki,gra ikota lekki lagos,9,5,4,5,1,1,1,1,9,5600000
1846,lekki,lagasa rd oribanwa ibeju lekki lagos,2,1,1,1,0,0,0,0,4,400000
1847,lekki," shapati, bogije ibeju lekki lagos",5,3,2,3,0,0,0,0,7,1000000
1848,lekki,lekky county estate ikota lekki lagos,10,5,5,5,0,0,0,1,9,3500000
1849,lekki,new road/alfa beach road lekki lagos,2,1,1,1,0,0,0,0,4,400000
1850,lekki,agungi lekki lagos,7,4,3,4,0,0,0,0,7,2000000
1851,lekki,.. ikate lekki lagos,7,4,3,4,0,0,0,0,7,2000000
1852,lekki,- lekki phase 1 lekki lagos,5,3,2,3,0,0,0,0,7,1700000
1853,lekki,jakande jakande lekki lagos,2,1,1,1,1,1,1,1,4,1300000
1854,lekki,agungi lekki lagos,2,1,1,1,0,0,0,1,4,1100000
1855,lekki,.. ikate lekki lagos,6,3,3,3,0,0,0,0,7,1700000
1856,lekki,idado idado lekki lagos,8,4,4,4,0,0,0,1,7,2500000
1857,lekki,agungi agungi lekki lagos,5,3,2,3,0,0,0,1,7,2000000
1858,lekki,directly off fola osibo lekki phase 1 lekki lagos,12,6,6,6,1,1,0,1,10,6200000
1859,lekki,gbo efon igbo efon lekki lagos,7,4,3,4,0,0,0,0,7,2000000
1860,lekki,chevron drive lekki phase 2 lekki lagos,12,6,6,6,0,0,0,0,10,5000000
1861,lekki,idado estates idado lekki lagos,7,4,3,4,0,0,0,0,7,2000000
1862,lekki,osapa osapa london lekki lagos,9,5,4,5,1,0,1,1,9,4500000
1863,lekki,osapa osapa london lekki lagos,11,6,5,6,0,0,0,0,10,4700000
1864,lekki,- lekki lagos,10,5,5,5,1,1,1,1,9,5600000
1865,lekki,lekki county estate ikota lekki lagos,6,3,3,3,1,1,0,1,7,2730000
1866,lekki,orchid road victoria crest estate lekki lagos,10,5,5,5,0,0,0,1,9,3500000
1867,lekki," bakare estate, in a gated secured estate agungi lekki lagos",5,3,2,3,0,0,0,0,7,1600000
1868,lekki,osapa osapa london lekki lagos,7,4,3,4,1,0,0,1,7,3000000
1869,lekki," orchid, lafiaji lekki lagos",9,5,4,5,0,0,0,1,9,3500000
1870,lekki,osapa osapa london lekki lagos,6,3,3,3,1,1,0,1,7,2500000
1871,lekki,agungi lekki lagos,7,4,3,4,0,0,0,0,7,2000000
1872,lekki,lafiaji lekki lagos,9,5,4,5,0,0,0,1,9,3500000
1873,lekki,chevron chevron lekki lagos,5,3,2,3,0,0,0,0,7,1800000
1874,lekki,ologolo ologolo lekki lagos,6,3,3,3,0,0,0,0,7,1000000
1875,lekki,off castle and temp drive lekki lekki phase 1 lekki lagos,7,4,3,4,1,1,1,1,7,4300000
1876,lekki,off omorire johnson lekki phase 1 lekki lagos,9,5,4,5,1,1,1,1,9,5600000
1877,lekki,ikate lekki lagos,8,4,4,4,1,1,1,1,7,4000000
1878,lekki,off admirality way lekki phase1 lekki phase 1 lekki lagos,7,4,3,4,1,1,1,1,7,4300000
1879,lekki,in a well secured estate ikota lekki lagos,5,3,2,3,0,0,0,0,7,1600000
1880,lekki,117 opebi road ikeja agungi lekki lagos,3,2,1,2,0,0,0,0,6,1200000
1881,lekki,elegushi lekki phase 1 lekki lagos,8,4,4,4,0,0,0,1,7,2500000
1882,lekki,lekki phase 1 lekki lagos,10,5,5,5,0,0,0,1,9,3500000
1883,lekki,lekki phase 1 lekki phase 1 lekki lagos,12,6,6,6,1,1,0,1,10,6200000
1884,lekki,jakande jakande lekki lagos,9,5,4,5,0,0,0,1,9,3500000
1885,lekki,lekki lekki phase 1 lekki lagos,11,6,5,6,1,1,0,1,10,6200000
1886,lekki,... chevron lekki lagos,8,4,4,4,1,1,1,1,7,4300000
1887,lekki,6th avenue eletu osapa london osapa london lekki lagos,12,6,6,6,0,0,0,0,10,5000000
1888,lekki,gabriel okoi street ikate lekki lagos,7,4,3,4,0,0,0,0,7,2300000
1889,lekki,"off admiralty way, lekki phase 1,1 lekki phase 1 lekki lagos",2,1,1,1,1,1,1,1,4,1500000
1890,lekki,maruwa lekki phase 1 lekki lagos,9,5,4,5,1,0,0,1,9,4000000
1891,lekki,behind elevation church ilasan lekki lagos,9,5,4,5,0,0,0,1,9,3500000
1892,lekki,chevyview estate chevron lekki lagos,6,3,3,3,1,1,1,1,7,3000000
1893,lekki,.. osapa london lekki lagos,7,4,3,4,0,0,0,0,7,2000000
1894,lekki,.. osapa london lekki lagos,9,5,4,5,0,0,0,1,9,3500000
1895,lekki,osapa osapa london lekki lagos,4,2,2,2,1,1,1,1,6,2500000
1896,lekki,horizon 2 lekki gardens ikate lagos ikate lekki lagos,10,5,5,5,1,1,1,1,9,5000000
1897,lekki,lafiaji lekki phase 1 lekki lagos,9,5,4,5,0,0,0,1,9,3500000
1898,lekki,divine estate lekki phase 1 lekki lagos,4,2,2,2,1,1,1,1,6,2500000
1899,lekki,chevy view alternative route vgc lekki lagos,10,5,5,5,1,0,0,1,9,4000000
1900,lekki,jakande lekki lagos,2,1,1,1,1,0,0,1,4,1200000
1901,lekki," lafiaji, lekki lagos",9,5,4,5,0,0,0,1,9,3500000
1902,lekki," kazeem eletu way osapa london, osapa london lekki lagos",11,6,5,6,0,0,0,0,10,4700000
1903,lekki,"second lekki toll gate, orchid lekki phase 2 lekki lagos",8,4,4,4,1,1,1,1,7,4200000
1904,lekki,lekki phase 1 lekki phase 1 lekki lagos,11,6,5,6,1,1,0,1,10,6200000
1905,lekki," lafiaji, lekki lagos",10,6,4,6,0,0,0,0,10,4700000
1906,lekki,horison court ikate lekki lagos,3,2,1,2,1,0,0,1,6,1800000
1907,lekki,- ikota lekki lagos,9,5,4,5,0,0,0,1,9,3500000
1908,lekki,spring bey estate off freedom way lekki phase 1 lekki lagos,11,6,5,6,0,0,0,0,10,4700000
1909,lekki," adegbenle street, chevy view estate, chevron drive, lekki osapa london lekki lagos",9,5,4,5,0,0,0,1,9,3500000
1910,lekki,osapa osapa london lekki lagos,9,5,4,5,0,0,0,1,9,3500000
1911,lekki,lekki county estate lekki lekki phase 1 lekki lagos,9,5,4,5,1,0,1,1,9,4500000
1912,lekki," friends colony estate, agungi agungi lekki lagos",9,5,4,5,0,0,0,1,9,3500000
1913,lekki," friends colony, agungi axis agungi lekki lagos",9,5,4,5,0,0,0,1,9,3500000
1914,lekki,ikate elegushi ikate lekki lagos,7,4,3,4,0,0,0,1,7,2500000
1915,lekki,. lekki phase 1 lekki lagos,9,5,4,5,1,0,0,1,9,4000000
1916,lekki,lekki chevron lagos chevron lekki lagos,10,5,5,5,0,0,0,1,9,3500000
1917,lekki," beside earl court, ikate elegushi, lagos state ikate lekki lagos",9,5,4,5,1,0,0,1,9,4000000
1918,lekki,orchid road lekki phase 1 lekki lagos,11,6,5,6,0,0,0,0,10,4700000
1919,lekki,maruwa lekki lagos,9,5,4,5,0,0,0,1,9,3500000
1920,lekki,orchid road chevron lekki lagos,9,5,4,5,0,0,0,1,9,3500000
1921,lekki,chevron lekki lagos,8,5,3,5,0,0,0,1,9,3800000
1922,lekki,the grantham estate lekki phase 2 lekki lagos,9,5,4,5,0,0,0,1,9,3500000
1923,lekki,ilasan lekki lagos,6,3,3,3,0,0,0,1,7,2200000
1924,lekki,emcel court ikota gra lekki ikota lekki lagos,11,5,6,5,0,0,0,1,9,3500000
1925,lekki,ikate lekki lagos,6,3,3,3,1,1,0,1,7,2500000
1926,lekki,osapa london lekki lagos,11,6,5,6,0,0,0,0,10,4700000
1927,lekki,bera estate chevron lekki lagos,11,6,5,6,0,0,0,0,10,4700000
1928,lekki,admiralty road lekki phase 1 lekki phase 1 lekki lagos,11,6,5,6,1,1,0,1,10,6200000
1929,lekki,chief augustine anozie lekki phase 1 lekki lagos,3,1,2,1,1,1,1,1,4,2000000
1930,lekki,chief augustine anozie lekki phase 1 lekki lagos,7,2,5,2,1,1,1,1,6,3000000
1931,lekki,chesachi hani-okoroafor close lekki phase 1 lekki lagos,13,7,6,7,0,0,0,0,10,5500000
1932,lekki," bogije along lekki/epe express way ,lagos lacampaigne tropicana ibeju lekki lagos",6,3,3,3,1,1,1,1,7,3500000
1933,lekki,ajah lekki gardens estate ajah lagos,10,5,5,5,1,1,1,1,9,5600000
1934,lekki," chevron, lekki, lagos chevron lekki lagos",9,5,4,5,0,0,0,1,9,3500000
1935,lekki," ologolo street, off lekki epe express, by dominos agungi. lekki lagos agungi lekki lagos",11,6,5,6,0,0,0,0,10,4700000
1936,lekki,ologolo road agungi lekki lagos,9,5,4,5,0,0,0,1,9,3500000
1937,lekki," mayfair garden estate, awoyaya eputu ibeju lekki lagos",7,4,3,4,0,0,0,0,7,2000000
1938,lekki,marwa lekki phase 1 lekki lagos,9,5,4,5,1,0,0,1,9,4000000
1939,lekki,university view estate opposite lagos business school off lekki epe expressway ajah lagos,2,1,1,1,0,0,0,0,4,500000
1940,ogba,obawole area ifako ogba ogba lagos,6,3,3,3,0,0,0,0,3,500000
1941,ogba,obawole area ifako ogba ogba lagos,2,1,1,1,0,0,0,0,1,120000
1942,ogba,obawole area ifako ogba ogba lagos,5,3,2,3,0,0,0,1,3,650000
1943,ogba,off college road ifako ogba ogba lagos,4,2,2,2,0,0,0,0,3,400000
1944,ogba,at obawole area ifako ogba ogba lagos,2,1,1,1,0,0,0,0,1,200000
1945,ogba,college road ifako ogba ogba lagos,2,1,1,1,0,0,0,0,1,170000
1946,ogba,off college road ifako ogba ogba lagos,4,2,2,2,0,0,0,1,3,600000
1947,ogba,obawole area ifako ogba ogba lagos,2,1,1,1,0,0,0,0,1,180000
1948,ogba,obawole area ifako ogba ogba lagos,2,1,1,1,0,0,0,1,1,250000
1949,ogba,obawole area ifako ogba ogba lagos,4,2,2,2,0,0,0,0,3,400000
1950,ogba,obawole area ifako ogba ogba lagos,7,4,3,4,0,0,0,0,4,700000
1951,ogba,near airtel office aguda(ogba) ogba lagos,4,2,2,2,1,1,0,1,3,650000
1952,ogba,obawole area ifako ogba ogba lagos,7,4,3,4,0,0,0,0,4,750000
1953,ogba,off college road ifako ogba ogba lagos,6,3,3,3,1,1,1,1,3,1000000
1954,ogba,obawole area ifako ogba ogba lagos,6,3,3,3,0,0,0,0,3,600000
1955,ogba,obawole area ifako ogba ogba lagos,5,3,2,3,0,0,0,0,3,500000
1956,ogba,obawole area ifako ogba ogba lagos,6,3,3,3,0,0,0,1,3,650000
1957,ogba,obawole area ifako ogba ogba lagos,2,1,1,1,0,0,0,0,1,120000
1958,ogba,"  kay farm estate, obawale, ogba ikeja lagos",5,3,2,3,0,0,0,1,3,650000
1959,ogba,kay farm estate obawole ogba lagos ogba lagos,5,3,2,3,0,0,0,1,3,650000
1960,ogba,behind nationwide filling station.... aguda(ogba) ogba lagos,2,1,1,1,1,0,0,1,1,300000
1961,ogba,kay farm estate off college road ogba aguda(ogba) ogba lagos,4,2,2,2,0,0,0,0,3,500000
1962,ogba,kadiri street...... ajayi road ogba lagos,2,1,1,1,1,0,1,1,1,350000
1963,ogba,karaole estate..off college road..... ifako ogba ogba lagos,2,1,1,1,0,0,0,0,1,220000
1964,ogba,off power line obawole ifako ogba ogba lagos,2,1,1,1,1,0,0,1,1,300000
1965,ogba,aguda(ogba) ogba lagos,2,1,1,1,1,1,1,1,1,380000
1966,ogba,aguda area..... ajayi road ogba lagos,8,4,4,4,0,0,0,1,4,800000
1967,ogba,olanipekun estate...... ajayi road ogba lagos,2,1,1,1,1,1,1,1,1,380000
1968,ogba,mobil.....ola street...... ajayi road ogba lagos,6,3,3,3,1,0,0,1,3,750000
1969,ogba,mobil area..... ajayi road ogba lagos,6,3,3,3,0,0,0,1,3,650000
1970,ogba," haruna area,off college road.... ogba lagos",4,2,2,2,0,0,0,0,3,500000
1971,ogba,ogba aguda(ogba) ogba lagos,3,2,1,2,1,1,1,1,3,700000
1972,ogba,jacob shonola street...... ajayi road ogba lagos,6,3,3,3,0,0,0,1,3,700000
1973,ogba,yusufu street...... ajayi road ogba lagos,6,3,3,3,1,1,0,1,3,800000
1974,ogba,oke-ira...... ajayi road ogba lagos,6,3,3,3,0,0,0,1,3,650000
1975,ogba,oladoyinbo street...... aguda(ogba) ogba lagos,4,2,2,2,1,1,0,1,3,650000
1976,ogba,off ajayi road ajayi road ogba lagos,2,1,1,1,1,0,0,1,1,300000
1977,ogba,ayo alabi area....... ajayi road ogba lagos,4,2,2,2,0,0,0,0,3,400000
1978,ogba,oyatogun street ajayi road ogba lagos,2,1,1,1,1,0,0,1,1,300000
1979,ogba,off college road ifako ogba ogba lagos,4,2,2,2,0,0,0,0,3,500000
1980,ogba,shonola street....... aguda(ogba) ogba lagos,2,1,1,1,1,1,1,1,1,380000
1981,ogba,iju obawole ifako ogba ogba lagos,2,1,1,1,0,0,0,0,1,200000
1982,ogba,oke-ira..... ajayi road ogba lagos,8,4,4,4,0,0,0,0,4,700000
1983,ogba,obawole iju ogba iju lagos,6,3,3,3,1,0,0,1,3,750000
1984,ogba,off lucas street ifako ogba ogba lagos,5,3,2,3,0,0,0,1,3,650000
1985,ogba,oke ira ogba lagos,2,1,1,1,1,1,1,1,1,500000
1986,ogba,modupe area..... ajayi road ogba lagos,4,2,2,2,0,0,0,1,3,550000
1987,ogba,ajayi road ogba lagos,4,2,2,2,0,0,0,0,3,500000
1988,ogba,ogunshola street..... aguda(ogba) ogba lagos,6,3,3,3,0,0,0,0,3,500000
1989,ogba,otuba street.oke-ira..... ajayi road ogba lagos,2,1,1,1,1,0,0,1,1,300000
1990,ogba,fadeyi street..... aguda(ogba) ogba lagos,6,3,3,3,0,0,0,0,3,500000
1991,ogba,ajayi road..... oke ira ogba lagos,4,2,2,2,0,0,0,1,3,600000
1992,ogba,behind county hospital....... aguda(ogba) ogba lagos,4,2,2,2,1,1,0,1,3,650000
1993,ogba,alafia estate...... ogba lagos,4,2,2,2,0,0,0,1,3,550000
1994,ogba,olanipekun estate....... oke ira ogba lagos,6,3,3,3,0,0,0,0,3,500000
1995,ogba,oke ira ogba lagos,6,3,3,3,0,0,0,0,3,550000
1996,ogba,behind county hospital..... aguda(ogba) ogba lagos,4,2,2,2,1,1,0,1,3,650000
1997,ogba,sumonu street..... oke ira ogba lagos,2,1,1,1,0,0,0,1,1,250000
1998,ogba,aguda ogba area..... ogba lagos,6,3,3,3,0,0,0,0,3,550000
1999,ogba,aguda(ogba) ogba lagos,6,3,3,3,0,0,0,1,3,650000
2000,ogba,ajayi road oke-ira.... ogba lagos,6,3,3,3,0,0,0,0,3,600000
2001,ogba,aguda.... ajayi road ogba lagos,6,3,3,3,0,0,0,0,3,600000
2002,ogba,aguda...... ifako ogba ogba lagos,4,2,2,2,0,0,0,0,3,400000
2003,ogba,k farm estate ifako ogba ogba lagos,5,3,2,3,0,0,0,1,3,650000
2004,ogba,obawole ifako ogba ogba lagos,5,3,2,3,0,0,0,0,3,500000
2005,ogba,ogundele avenue...... ajayi road ogba lagos,2,1,1,1,1,1,1,1,1,450000
2006,ogba,ola street...... ajayi road ogba lagos,6,3,3,3,0,0,0,1,3,650000
2007,ogba,aguda(ogba) ogba lagos,6,3,3,3,0,0,0,0,3,550000
2008,ogba,alafia estate....... aguda(ogba) ogba lagos,4,2,2,2,0,0,0,0,3,400000
2009,ogba,aguda(ogba) ogba lagos,6,3,3,3,1,1,0,1,3,800000
2010,ogba,mobil....... ajayi road ogba lagos,6,3,3,3,1,0,0,1,3,750000
2011,ogba,fako estate...... oke ira ogba lagos,4,2,2,2,0,0,0,1,3,550000
2012,ogba,williams estate....... oke ira ogba lagos,6,3,3,3,1,1,1,1,3,850000
2013,ogba,muibi street...... aguda(ogba) ogba lagos,6,3,3,3,0,0,0,0,3,550000
2014,ogba,oke-ira.... ajayi road ogba lagos,2,1,1,1,0,0,0,0,1,200000
2015,ogba,aguda........ ajayi road ogba lagos,2,1,1,1,0,0,0,0,1,200000
2016,ogba," akilo road,very close to the stadium..... ogba lagos",6,3,3,3,1,1,0,1,3,800000
2017,ogba,alafia estate..... ogba lagos,4,2,2,2,1,1,1,1,3,700000
2018,ogba,aguda area.... ogba lagos,6,3,3,3,0,0,0,0,3,600000
2019,ogba,34 oyatogun street.... aguda(ogba) ogba lagos,6,3,3,3,0,0,0,0,3,550000
2020,ogba,ogba obawole ifako ogba ogba lagos,4,2,2,2,1,1,1,1,3,700000
2021,ogba,obawole ifako ogba ogba lagos,7,4,3,4,0,0,0,0,4,750000
2022,ogba,oke-ira........ ajayi road ogba lagos,4,2,2,2,0,0,0,0,3,450000
2023,ogba,fadunsi street...... oke ira ogba lagos,6,3,3,3,0,0,0,0,3,550000
2024,ogba,behind county hospital.... aguda(ogba) ogba lagos,4,2,2,2,1,1,0,1,3,650000
2025,ogba,behind nationwide filling station..... aguda(ogba) ogba lagos,2,1,1,1,1,0,0,1,1,300000
2026,ogba,ola street..... ajayi road ogba lagos,6,3,3,3,0,0,0,0,3,550000
2027,ogba,modupe oke-ira.... ajayi road ogba lagos,2,1,1,1,0,0,0,0,1,180000
2028,ogba,k farm estate ifako ogba ogba lagos,7,4,3,4,0,0,0,0,4,700000
2029,ogba,okeira ifako ogba ogba lagos,5,3,2,3,1,1,0,1,3,800000
2030,ogba,okeira ogba ifako ogba ogba lagos,5,3,2,3,0,0,0,1,3,700000
2031,ogba,ogundele avenue..... oke ira ogba lagos,6,3,3,3,0,0,0,0,3,600000
2032,ogba,muibi street....... aguda(ogba) ogba lagos,6,3,3,3,0,0,0,0,3,500000
2033,ogba,ondo street...... oke ira ogba lagos,4,2,2,2,0,0,0,0,3,500000
2034,ogba,off ajayi road...... oke ira ogba lagos,4,2,2,2,0,0,0,0,3,500000
2035,ogba,oladoyinbo street..... aguda(ogba) ogba lagos,4,2,2,2,1,1,1,1,3,700000
2036,ogba,aguda area...... ogba lagos,6,3,3,3,0,0,0,0,3,500000
2037,ogba,adeshina street..... ajayi road ogba lagos,6,3,3,3,0,0,0,0,3,500000
2038,ogba,shonola street....... aguda(ogba) ogba lagos,2,1,1,1,1,1,1,1,1,500000
2039,ogba,opposite williams estate.... oke ira ogba lagos,2,1,1,1,0,0,0,0,1,200000
2040,ogba,off college road ifako ogba ogba lagos,2,1,1,1,0,0,0,1,1,250000
2041,ogba,bintu street.... ajayi road ogba lagos,6,3,3,3,1,1,1,1,3,1000000
2042,ogba,oke ira ogba lagos,2,1,1,1,0,0,0,0,1,200000
2043,ogba,.. oke ira ogba lagos,6,3,3,3,1,1,1,1,3,1000000
2044,ogba,oke ira ogba lagos,6,3,3,3,0,0,0,1,3,700000
2045,ogba,obawole area ifako ogba ogba lagos,4,2,2,2,0,0,0,0,3,400000
2046,ogba,at obawole area ifako ogba ogba lagos,7,4,3,4,0,0,0,0,4,700000
2047,ogba,oke ira ogba lagos,2,1,1,1,1,0,0,1,1,300000
2048,ogba,adekoya estate aguda(ogba) ogba lagos,9,5,4,5,1,1,0,1,6,1500000
2049,ogba,oke ira ogba lagos,3,2,1,2,0,0,0,0,3,500000
2050,ogba,adekoya estate aguda(ogba) ogba lagos,7,4,3,4,1,0,0,1,4,1000000
2051,ogba,kayode street ogba lagos,2,1,1,1,1,1,1,1,1,380000
2052,ogba,oke ira ogba lagos,2,1,1,1,0,0,0,1,1,250000
2053,ogba,kfarm estate ifako ogba ogba lagos,6,4,2,4,0,0,0,0,4,700000
2054,ogba,college road ifako ogba ogba lagos,5,3,2,3,0,0,0,0,3,500000
2055,ogba,.. oke ira ogba lagos,2,1,1,1,0,0,0,0,1,150000
2056,ogba,very decent and beautiful 2bedroom at ogba college road ogba lagos,4,2,2,2,0,0,0,1,3,600000
2057,ogba,oyemekunstreet ogba bus stop ogba lagos,6,3,3,3,0,0,0,1,3,700000
2058,ogba,college road ifako ogba ogba lagos,5,3,2,3,0,0,0,0,3,600000
2059,ogba,enahoro estate ogba bus stop ogba lagos,3,2,1,2,1,1,1,1,3,800000
2060,ogba,oke ira ogba lagos,5,3,2,3,1,1,0,1,3,800000
2061,ogba,oke ira ogba lagos,4,2,2,2,1,1,1,1,3,800000
2062,ogba,ifako ogba ogba lagos,6,3,3,3,0,0,0,1,3,700000
2063,ogba,iju road ifako agege lagos,5,3,2,3,0,0,0,0,3,500000
2064,ogba,kadiri street oke ira ogba lagos,2,1,1,1,1,0,0,1,1,300000
2065,ogba,oke ira ogba lagos,6,3,3,3,0,0,0,0,3,600000
2066,ogba,off college road ogba lagos,7,4,3,4,1,0,0,1,4,1000000
2067,ogba,obawole ogba lagos,2,1,1,1,0,0,0,0,1,170000
2068,ogba,off college road ogba lagos,2,1,1,1,0,0,0,0,1,200000
2069,ogba,ajayi road ajayi road ogba lagos,4,2,2,2,0,0,0,0,3,450000
2070,ogba,college road ifako ogba ogba lagos,4,2,2,2,0,0,0,0,3,500000
2071,ogba,college road ifako ogba ogba lagos,2,1,1,1,1,1,1,1,1,500000
2072,ogba,near fadunsi street ajayi road ogba lagos,7,4,3,4,1,1,1,1,4,1200000
2073,ogba,ogba lagos,6,3,3,3,0,0,0,0,3,600000
2074,ogba,ogba lagos,6,3,3,3,0,0,0,1,3,700000
2075,ogba,.. ifako ogba ogba lagos,10,5,5,5,1,1,0,1,6,1500000
2076,ogba,off college road ifako ogba ifako ogba ogba lagos,4,2,2,2,0,0,0,1,3,600000
2077,ogba,off ajayi oke ira ogba lagos,8,4,4,4,1,0,0,1,4,1000000
2078,ogba,ogba off ajayi road oke ira off aguda via excellence hotel. oke ira ogba lagos,5,3,2,3,1,1,0,1,3,800000
2079,ogba,estate ogba lagos,11,5,6,5,1,1,0,1,6,1500000
2080,ogba,ogba lagos,8,4,4,4,1,1,1,1,4,1300000
2081,ogba,aguda(ogba) ogba lagos,6,3,3,3,1,1,1,1,3,1000000
2082,ogba,oke ira ogba lagos,2,1,1,1,1,1,1,1,1,380000
2083,ogba,ifako ogba ogba lagos,5,3,2,3,0,0,0,1,3,650000
2084,ogba,ogba gra ogba gra ogba lagos,5,3,2,3,1,1,1,1,3,1000000
2085,ogba,in a close oke ira ogba lagos,5,3,2,3,1,0,0,1,3,750000
2086,ogba,ifako ijaiye ifako ogba ogba lagos,4,2,2,2,0,0,0,1,3,600000
2087,ogba,obawole off ogba ikeja lagos,6,3,3,3,1,0,0,1,3,750000
2088,ogba,obawole off ogba ikeja lagos,6,3,3,3,1,0,0,1,3,750000
2089,ogba,ogba lagos,4,2,2,2,0,0,0,1,3,600000
2090,ogba,before modupe oke ira ajayi road ogba lagos,5,3,2,3,1,1,0,1,3,800000
2091,ogba," off ayo-alabi street oke-ira, ogba ikeja lagos",6,3,3,3,1,0,0,1,3,750000
2092,ogba,ogba ikeja lagos,7,4,3,4,1,1,1,1,4,1200000
2093,ikeja,toyin street ikeja lagos,8,4,4,4,0,0,0,1,8,3800000
2094,ikeja,allen avenue ikeja lagos,7,4,3,4,1,1,0,1,8,4000000
2095,ikeja,opebi ikeja lagos,13,7,6,7,1,1,0,1,10,6800000
2096,ikeja,ikeja gra ikeja gra ikeja lagos,9,5,4,5,0,0,0,1,9,5000000
2097,ikeja,toyin street ikeja lagos,6,3,3,3,0,0,0,1,6,1500000
2098,ikeja,"  ikeja gra, ikeja lagos",8,5,3,5,0,0,0,0,9,3500000
2099,ikeja,within an estate adeniyi jones ikeja lagos,12,6,6,6,0,0,0,0,10,5000000
2100,ikeja,ikeja gra ikeja lagos,9,5,4,5,1,1,0,1,9,5500000
2101,ikeja,abc estate adeniyi jones ikeja lagos,12,6,6,6,1,1,0,1,10,6200000
2102,ikeja,"  awuse estate, opebi opebi ikeja lagos",7,4,3,4,0,0,0,0,8,2000000
2103,ikeja,near chrisland schools opebi ikeja lagos,7,4,3,4,0,0,0,0,8,2000000
2104,ikeja,"  awuse estate, opebi, ikeja, lagos opebi ikeja lagos",7,4,3,4,0,0,0,0,8,2000000
2105,ikeja,allen allen avenue ikeja lagos,7,4,3,4,1,1,0,1,8,4000000
2106,ikeja,adeniyi jones ikeja lagos,9,5,4,5,0,0,0,0,9,3500000
2107,ikeja,"  awuse estate, opebi, ikeja, lagos opebi ikeja lagos",7,4,3,4,0,0,0,0,8,2000000
2108,ikeja,"  awuse estate, opebi, ikeja opebi ikeja lagos",7,4,3,4,0,0,0,1,8,3000000
2109,ikeja,off isaac john street ikeja gra ikeja lagos,9,5,4,5,0,0,0,1,9,5000000
2110,ikeja,bamishele estate off allen opebi ikeja lagos,7,4,3,4,1,1,0,1,8,4000000
2111,ikeja,off allen avenue allen avenue ikeja lagos,7,4,3,4,1,1,0,1,8,4000000
2112,ikeja,"  off ogunlani estate, allen, ikeja. allen avenue ikeja lagos",12,6,6,6,0,0,0,0,10,4700000
2113,ikeja,aba johnson street adeniyi jones ikeja lagos,15,8,7,8,1,1,0,1,10,7000000
2114,ikeja,"  awuse estate, obepi, ikeja, lagos opebi ikeja lagos",4,2,2,2,1,1,1,1,5,2000000
2115,ikeja,adeniyi jones ikeja lagos,12,6,6,6,0,0,0,0,10,5500000
2116,ikeja,oba aladejobi street ikeja gra ikeja lagos,7,4,3,4,1,1,0,1,8,4000000
2117,ikeja,"alhaji basheer shittu street magodo shangisha phase 2, ikeja lagos",11,6,5,6,0,0,0,1,10,6000000
2118,ikeja,ikeja gra ikeja gra ikeja lagos,9,5,4,5,1,1,0,1,9,5500000
2119,ikeja,alfred garden estate oregun ikeja oregun ikeja lagos,7,4,3,4,1,1,0,1,8,4000000
2120,ikeja,"  adeniyi jones ikeja, adeniyi jones ikeja lagos",7,4,3,4,0,0,0,0,8,2000000
2121,ikeja,in an estate at adeniyi jones ikeja lagos adeniyi jones ikeja lagos,11,6,5,6,0,0,0,0,10,4700000
2122,ikeja,ikeja gra ikeja lagos,7,4,3,4,0,0,0,1,8,3200000
2123,ikeja,ikeja gra ikeja lagos,9,5,4,5,1,1,0,1,9,5500000
2124,ikeja,adekunle fajuyi ikeja gra ikeja lagos,3,2,1,2,0,0,0,1,5,1000000
2125,ikeja,"  kay farm estate, obawale, ogba ikeja lagos",5,3,2,3,0,0,0,0,6,900000
2126,ikeja,ikeja gra ikeja lagos,9,5,4,5,1,1,0,1,9,5500000
2127,ikeja,allen avenue ikeja lagos,8,5,3,5,0,0,0,0,9,3500000
2128,ikeja,- ikeja gra ikeja lagos,9,5,4,5,1,1,0,1,9,5500000
2129,ikeja,allen avenue ikeja lagos,7,4,3,4,0,0,0,0,8,2000000
2130,ikeja,titilope street omole estate ph1 agidingbi ikeja lagos,11,6,5,6,0,0,0,0,10,5000000
2131,ikeja,... toyin street ikeja lagos,8,4,4,4,0,0,0,0,8,2000000
2132,ikeja,off adeniyi jones adeniyi jones ikeja lagos,14,6,8,6,0,0,0,0,10,5000000
2133,ikeja,akiode ojodu...... ikeja lagos,6,3,3,3,0,0,0,0,6,900000
2134,ikeja,"omole ph.1,estate..... ikeja lagos",2,1,1,1,1,1,1,1,2,800000
2135,ikeja,"omole ph.1,estate.. ikeja lagos",10,5,5,5,0,0,0,0,9,3500000
2136,ikeja,off opebi road opebi ikeja lagos,8,4,4,4,0,0,0,1,8,3000000
2137,ikeja,joel ogunike ikeja gra. lagos mainland ikeja gra ikeja lagos,10,5,5,5,0,0,0,0,9,4000000
2138,ikeja,.river valley estate.ojodu berger. ikeja lagos,10,5,5,5,0,0,0,0,9,3500000
2139,ikeja," ogundele street, ajayi rd.ogba.... ikeja lagos",4,2,2,2,0,0,0,0,5,800000
2140,ikeja,- adeniyi jones ikeja lagos,7,4,3,4,0,0,0,0,8,2500000
2141,ikeja," adeniyi jones, ikeja, lagos adeniyi jones ikeja lagos",6,3,3,3,1,1,1,1,6,3500000
2142,ikeja,olowora ojodu berger ikeja lagos olowora ojodu lagos,7,4,3,4,0,0,0,0,8,2000000
2143,ikeja,olowora..berger ojodu. ikeja lagos,4,2,2,2,0,0,0,0,5,800000
2144,ikeja,budland estate ojodu..... ikeja lagos,8,4,4,4,0,0,0,0,8,2000000
2145,ikeja,olutoye crescent adeniyi jones ikeja lagos,13,7,6,7,1,1,0,1,10,6800000
2146,ikeja,fani kayode ikeja gra ikeja lagos,9,5,4,5,1,1,0,1,9,5500000
2147,ikeja,by okupe estate maryland ikeja lagos,8,4,4,4,1,1,0,1,8,4000000
2148,ikeja,afred garden oregun ikeja lagos,4,2,2,2,1,0,1,1,5,1500000
2149,ikeja,ikeja g r a ikeja lagos ikeja gra ikeja lagos,9,5,4,5,1,1,0,1,9,5500000
2150,ikeja,oduduwa street ikeja g r a ikeja lagos ikeja gra ikeja lagos,9,5,4,5,1,1,0,1,9,5500000
2151,ikeja,"opposite omole ph.1,estate gate.... agidingbi ikeja lagos",2,1,1,1,0,0,0,0,2,400000
2152,ikeja,cement mangoro mangoro ikeja lagos,8,4,4,4,0,0,0,0,8,2000000
2153,ikeja,opebi opebi ikeja lagos,7,4,3,4,0,0,0,0,8,2300000
2154,ikeja,g.r.a ikeja gra ikeja lagos,11,6,5,6,1,1,0,1,10,6200000
2155,ikeja,ikeja ikeja gra ikeja lagos,9,5,4,5,1,1,0,1,9,5500000
2156,ikeja,... maryland ikeja lagos,8,4,4,4,0,0,0,0,8,2200000
2157,ikeja,fani kayode street ikeja ikeja gra ikeja lagos,9,5,4,5,1,1,0,1,9,5500000
2158,ikeja,onipetesi estate mangoro ikeja lagos,3,1,2,1,0,0,0,0,2,400000
2159,ikeja,valley estate cement ikeja cement agege lagos,6,3,3,3,0,0,0,0,6,900000
2160,ikeja," ladipo kuku street, off allen avenue, lagos. toyin street ikeja lagos",5,3,2,3,0,0,0,0,6,1000000
2161,ikeja,oduduwa avenue ikeja lagos ikeja gra ikeja lagos,9,5,4,5,1,1,0,1,9,5500000
2162,ikeja,fani kayode street ikeja g r a ikeja lagos ikeja gra ikeja lagos,9,5,4,5,1,1,0,1,9,5500000
2163,ikeja,. allen avenue ikeja lagos,12,6,6,6,0,0,0,0,10,4700000
2164,ikeja,.. adeniyi jones ikeja lagos,6,3,3,3,0,0,0,0,6,1400000
2165,ikeja,ikeja g r a ikeja lagos ikeja gra ikeja lagos,9,5,4,5,1,1,0,1,9,5500000
2166,ikeja,ikeja gra ikeja lagos,2,1,1,1,1,1,1,1,2,1000000
2167,ikeja,ikeja gra ikeja lagos,4,2,2,2,0,0,0,1,5,1000000
2168,ikeja," off awolowo way,ikeja obafemi awolowo way ikeja lagos",7,4,3,4,0,0,0,0,8,2000000
2169,ikeja,adeniyi jones ikeja lagos,12,8,4,8,1,1,0,1,10,7000000
2170,ikeja,ikeja gra ikeja lagos,7,4,3,4,1,1,0,1,8,4000000
2171,ikeja,off toyin street toyin street ikeja lagos,6,3,3,3,0,0,0,1,6,1500000
2172,ikeja," off toyin street,ikeja toyin street ikeja lagos",6,3,3,3,0,0,0,0,6,900000
2173,ikeja,ikeja gra ikeja lagos,10,6,4,6,0,0,0,0,10,4700000
2174,ikeja,adeniyi jones ikeja lagos,7,4,3,4,0,0,0,1,8,3000000
2175,ikeja,peace estate oregun ikeja lagos,9,5,4,5,0,0,0,0,9,3500000
2176,ikeja,salvation opebi ikeja lagos,2,1,1,1,0,0,0,0,2,400000
2177,ikeja,off awolowo way obafemi awolowo way ikeja lagos,9,5,4,5,0,0,0,0,9,3500000
2178,ikeja,alausa ikeja lagos,7,4,3,4,0,0,0,1,8,3500000
2179,ikeja,off awolowo way obafemi awolowo way ikeja lagos,2,1,1,1,0,0,0,1,2,500000
2180,ikeja,off oregun oregun ikeja lagos,2,1,1,1,0,0,0,1,2,500000
2181,ikeja,off allen avenue allen avenue ikeja lagos,2,1,1,1,0,0,0,0,2,400000
2182,ikeja,off awolowo way obafemi awolowo way ikeja lagos,6,3,3,3,0,0,0,1,6,1500000
2183,ikeja,off awolowo way awolowo way ikeja lagos,4,2,2,2,0,0,0,0,5,800000
2184,ikeja,omole phase 1 ikeja gra ikeja lagos,12,6,6,6,0,0,0,1,10,6000000
2185,ikeja,off allen avenue allen avenue ikeja lagos,2,1,1,1,0,0,0,0,2,400000
2186,ikeja,oduduwa crescent ikeja gra ikeja lagos,11,6,5,6,1,1,0,1,10,6200000
2187,ikeja,alausa ikeja lagos,7,4,3,4,0,0,0,1,8,3500000
2188,ikeja,ikeja gra ikeja lagos,7,4,3,4,1,1,0,1,8,4000000
2189,ikeja,salvation opebi ikeja lagos,2,1,1,1,0,0,0,0,2,400000
2190,ikeja,off awolowo way obafemi awolowo way ikeja lagos,2,1,1,1,1,1,1,1,2,1000000
2191,ikeja,ikeja gra ikeja lagos,7,4,3,4,1,1,0,1,8,4000000
2192,ikeja,allen avenue ikeja lagos,8,4,4,4,0,0,0,1,8,3000000
2193,ikeja,oregun ikeja lagos,6,3,3,3,0,0,0,0,6,1000000
2194,ikeja,ladoke akintola off isaac john ikeja gra ikeja gra ikeja lagos,8,4,4,4,1,1,0,1,8,4000000
2195,ikeja,remi fani kayode ikeja gra ikeja lagos,11,5,6,5,1,1,0,1,9,5500000
2196,ikeja,amore street off toyin allen ikeja allen avenue ikeja lagos,9,5,4,5,0,0,0,0,9,3800000
2197,ikeja," abel oreniyi street, awuse estate, opebi ikeja opebi ikeja lagos",7,4,3,4,0,0,0,0,8,2500000
2198,ikeja,ikeja lagos,8,4,4,4,0,0,0,1,8,3000000
2199,ikeja,ikeja lagos,8,4,4,4,0,0,0,0,8,2000000
2200,ikeja,ikeja lagos,4,2,2,2,1,1,1,1,5,2200000
2201,ikeja,ikeja gra ikeja lagos,8,4,4,4,0,0,0,0,8,2500000
2202,ikeja,ikeja gra ikeja lagos,10,5,5,5,0,0,0,0,9,4000000
2203,ikeja,ikeja lagos,10,5,5,5,0,0,0,0,9,3500000
2204,ikeja,... adeniyi jones ikeja lagos,8,4,4,4,0,0,0,0,8,2700000
2205,ikeja,adeniyi jones ikeja lagos,10,5,5,5,0,0,0,0,9,3500000
2206,ikeja,opebi ikeja lagos,10,5,5,5,0,0,0,0,9,3500000
2207,ikeja,ikeja lagos,6,3,3,3,0,0,0,1,6,1500000
2208,ikeja,ikeja gra ikeja lagos,6,3,3,3,0,0,0,1,6,1800000
2209,ikeja,ikeja lagos,3,2,1,2,0,0,0,0,5,800000
2210,ikeja,ikeja lagos,10,5,5,5,0,0,0,0,9,3500000
2211,ikeja,ikeja gra ikeja gra ikeja lagos,8,4,4,4,1,1,0,1,8,4000000
2212,ikeja,ikeja gra ikeja lagos,8,4,4,4,0,0,0,0,8,2500000
2213,ikeja,... opebi ikeja lagos,10,5,5,5,0,0,0,0,9,3500000
2214,ikeja,ikeja lagos,3,2,1,2,0,0,0,0,5,800000
2215,ikeja,adeniyi jones ikeja lagos,6,3,3,3,0,0,0,1,6,1500000
2216,ikeja," awuse estate, opebi opebi ikeja lagos",11,6,5,6,0,0,0,0,10,4700000
2217,ikeja,showemimo str ikeja gra ikeja gra ikeja lagos,9,5,4,5,0,0,0,1,9,5000000
2218,ikeja,akora estate adeniyi jones ikeja lagos,9,5,4,5,0,0,0,0,9,3500000
2219,ikeja,allen avenue road ikeja allen avenue ikeja lagos,7,4,3,4,0,0,0,0,8,2000000
2220,ikeja," salvation bus stop opebi ikeja, lagos opebi ikeja lagos",5,3,2,3,0,0,0,0,6,1400000
2221,ikeja,ikeja lagos,2,1,1,1,1,0,0,1,2,700000
2222,ikeja,ikeja lagos,6,3,3,3,1,0,0,1,6,3000000
2223,ikeja,ikeja lagos,12,6,6,6,1,1,0,1,10,6200000
2224,ikeja,ikeja lagos,6,3,3,3,1,0,0,1,6,3000000
2225,ikeja,opebi ikeja lagos,6,3,3,3,0,0,0,1,6,1500000
2226,ikeja,arowojobe estate marylandland maryland ikeja lagos,10,5,5,5,0,0,0,0,9,3500000
2227,ikeja,toyin street ikeja lagos,4,2,2,2,1,0,0,1,5,1300000
2228,ikeja,ikeja lagos,2,1,1,1,1,1,1,1,2,800000
2229,ikeja,ikeja lagos,8,4,4,4,1,1,0,1,8,4000000
2230,ikeja,ikeja lagos,6,3,3,3,0,0,0,1,6,2000000
2231,ikeja,ikeja lagos,6,3,3,3,0,0,0,1,6,1500000
2232,ikeja,toyin street ikeja lagos,6,3,3,3,0,0,0,1,6,1500000
2233,ikeja,oregun oregun ikeja lagos,2,1,1,1,0,0,0,0,2,400000
2234,ikeja,off toyin street toyin street ikeja lagos,2,1,1,1,0,0,0,1,2,650000
2235,ikeja,adeniyi jones ikeja lagos,11,6,5,6,0,0,0,0,10,5000000
2236,ikeja,ikeja lagos,8,4,4,4,0,0,0,1,8,3000000
2237,ikeja,ikeja lagos,6,3,3,3,1,1,1,1,6,3500000
2238,ikeja,ikeja lagos,6,3,3,3,1,1,1,1,6,3500000
2239,ikeja,ikeja lagos,6,3,3,3,0,0,0,1,6,2800000
2240,ikeja,ikeja lagos,6,3,3,3,1,1,1,1,6,3500000
2241,ikeja,ikeja lagos,6,3,3,3,0,0,0,1,6,2500000
2242,ikeja,adeniyi jones ikeja lagos,11,6,5,6,0,0,0,0,10,5000000
2243,ikeja,0 ikeja gra ikeja lagos,13,7,6,7,1,1,0,1,10,6800000
2244,ikeja,"shangisha phase 2, magodo, ikeja lagos",9,5,4,5,0,0,0,0,9,3500000
2245,ikeja,allen allen avenue ikeja lagos,6,3,3,3,0,0,0,1,6,2000000
2246,ikeja,awuse estate opebi ikeja lagos,9,5,4,5,0,0,0,1,9,5000000
2247,ikeja,ikeja gra ikeja lagos,7,4,3,4,0,0,0,1,8,3500000
2248,ikeja,at ikeja gra ikeja lagos,5,3,2,3,1,0,0,1,6,3000000
2249,ikeja,"omole phase 2, ikeja lagos",11,6,5,6,0,0,0,0,10,4700000
2250,ikeja,ikeja omole omole phase 2 ojodu lagos,8,4,4,4,0,0,0,0,8,2000000
2251,ikeja,. ikeja gra ikeja lagos,7,4,3,4,1,1,0,1,8,4000000
2252,ikeja,0 ikeja gra ikeja lagos,11,6,5,6,1,1,0,1,10,6200000
2253,ikeja,awuse estate off opebi opebi ikeja lagos,7,4,3,4,0,0,0,1,8,3500000
2254,ikeja,off isaac john street ikeja gra ikeja lagos,9,5,4,5,0,0,0,1,9,5000000
2255,ikeja,. ikeja gra ikeja lagos,7,4,3,4,1,1,0,1,8,4000000
2256,ikeja,adeniyi jones ikeja lagos,6,3,3,3,0,0,0,0,6,1000000
2257,ikeja,0 adeniyi jones ikeja lagos,9,5,4,5,0,0,0,0,9,4000000
2258,ikeja,.. opebi ikeja lagos,8,4,4,4,0,0,0,0,8,2000000
2259,ikeja,mobolaji bank anthony way ikeja lagos,9,5,4,5,1,1,0,1,9,5500000
2260,ikeja,1 adeniyi jones ikeja lagos,7,4,3,4,1,1,0,1,8,4000000
2261,ikeja,opebi ikeja lagos,8,4,4,4,1,1,0,1,8,4000000
2262,ikeja,.. awolowo way ikeja lagos,4,2,2,2,0,0,0,0,5,800000
2263,ikeja,allen avenue ikeja lagos,10,5,5,5,0,0,0,0,9,3500000
2264,ikeja,ladipo bateye street ikeja gra ikeja lagos,8,4,4,4,1,1,0,1,8,4000000
2265,ikeja,ikeja off awolowo way. awolowo way ikeja lagos,4,2,2,2,0,0,0,0,5,800000
2266,ikeja,mangoro ikeja lagos,5,3,2,3,0,0,0,0,6,1100000
2267,ikeja,"shangisha phase 2, magodo, ikeja lagos",9,5,4,5,0,0,0,0,9,3500000
2268,ikeja,opebi ikeja lagos,5,3,2,3,0,0,0,0,6,1200000
2269,ikeja,at ikeja gra ikeja lagos,7,4,3,4,0,0,0,1,8,3500000
2270,ikeja,awuse estate opebi ikeja lagos,6,3,3,3,1,0,0,1,6,3000000
2271,ikeja,ikeja gra ikeja lagos,11,6,5,6,1,1,0,1,10,6200000
2272,ikeja,awuse estate opebi ikeja lagos,7,4,3,4,0,0,0,0,8,2000000
2273,ikeja,ikeja gra ikeja lagos,7,4,3,4,0,0,0,0,8,2500000
2274,ikeja,- adeniyi jones ikeja lagos,7,6,1,6,1,1,0,1,10,6200000
2275,ikeja,opebi ikeja lagos,7,4,3,4,0,0,0,0,8,2000000
2276,ikeja,adeniyi jones ikeja lagos,10,5,5,5,1,1,0,1,9,5500000
2277,ikeja,ikeja gra ikeja lagos,9,5,4,5,0,0,0,1,9,5000000
2278,ikeja,ikeja gra ikeja lagos,9,5,4,5,1,1,0,1,9,5500000
2279,ikeja,allen avenue ikeja lagos,7,4,3,4,0,0,0,0,8,2800000
2280,ikeja,.. awolowo way ikeja lagos,4,2,2,2,0,0,0,1,5,1000000
2281,ikeja,0 ikeja gra ikeja lagos,11,6,5,6,1,1,0,1,10,6200000
2282,ikeja,opebi ikeja lagos,10,5,5,5,1,1,0,1,9,5500000
2283,ikeja,opebi ikeja lagos,8,4,4,4,0,0,0,0,8,2000000
2284,ikeja,gra ikeja lagos,7,4,3,4,0,0,0,0,8,2000000
2285,ikeja,ikeja gra ikeja lagos,9,5,4,5,0,0,0,1,9,5000000
2286,ikeja,0 ikeja gra ikeja lagos,10,5,5,5,1,1,0,1,9,5500000
2287,ikeja,oregun ikeja lagos,8,4,4,4,0,0,0,0,8,2000000
2288,ikeja," along oregun road, ikeja oregun ikeja lagos",10,5,5,5,1,1,0,1,9,5500000
2289,ikeja,ikeja gra ikeja lagos,5,3,2,3,0,0,0,1,6,1500000
2290,ikeja,0 ikeja gra ikeja lagos,9,5,4,5,0,0,0,0,9,4000000
2291,ikeja,- adeniyi jones ikeja lagos,10,5,5,5,1,1,0,1,9,5500000
2292,ikeja,allen avenue ikeja lagos,8,4,4,4,0,0,0,0,8,2800000
2293,ikeja,opebi ikeja lagos,5,3,2,3,0,0,0,0,6,1200000
2294,ikeja,gra ikeja gra ikeja lagos,7,4,3,4,1,1,0,1,8,4000000
2295,ikeja,adeniyi jones ikeja lagos,9,5,4,5,0,0,0,0,9,3500000
2296,ikeja,... opebi ikeja lagos,8,4,4,4,0,0,0,0,8,2000000
2297,ikeja," unilag estate, gra, magodo ikeja lagos",7,4,3,4,0,0,0,0,8,2000000
2298,ikeja,opebi ikeja lagos,10,5,5,5,1,1,0,1,9,5500000
2299,ikeja,adeniyi jones ikeja lagos,6,3,3,3,0,0,0,0,6,1000000
2300,ikeja,coker estate alausa ikeja lagos,6,3,3,3,0,0,0,1,6,2000000
2301,ikeja,opebi ikeja lagos,4,2,2,2,1,1,1,1,5,1600000
2302,ikeja,shogunle street ikeja gra ikeja lagos,4,2,2,2,0,0,0,0,5,800000
2303,ikeja,ikeja gra ikeja lagos,11,6,5,6,1,1,0,1,10,6200000
2304,ikeja,allen avenue ikeja lagos,8,4,4,4,0,0,0,0,8,2500000
2305,ikeja,"shangisha phase 2, gra, magodo ikeja lagos",7,4,3,4,0,0,0,0,8,2500000
2306,ikeja,ikeja lagos,6,3,3,3,0,0,0,1,6,2500000
2307,ikeja,mangoro ikeja lagos,3,2,1,2,0,0,0,0,5,800000
2308,ikeja,airport road airport road(ikeja) ikeja lagos,6,3,3,3,0,0,0,1,6,1500000
2309,ikeja,toyin street ikeja lagos,2,1,1,1,0,0,0,1,2,650000
2310,ikeja," olowora isheri, isheri ikeja lagos",5,3,2,3,0,0,0,0,6,1100000
2311,ikeja,allen avenue ikeja lagos,2,1,1,1,1,1,1,1,2,1000000
2312,ikeja,opebi ikeja lagos,11,6,5,6,0,0,0,0,10,4700000
2313,ikeja,ikeja gra ikeja lagos,8,4,4,4,1,1,0,1,8,4000000
2314,ikeja,obafemi awolowo way ikeja lagos,6,3,3,3,0,0,0,0,6,1300000
2315,ikeja,alausa ikeja lagos,8,4,4,4,0,0,0,0,8,2000000
2316,ikeja," awolowo road ,ikeja awolowo way ikeja lagos",5,3,2,3,1,1,1,1,6,3500000
2317,ikeja,0 ikeja gra ikeja lagos,9,5,4,5,1,1,0,1,9,5500000
2318,ikeja,0 ikeja gra ikeja lagos,9,5,4,5,1,1,0,1,9,5500000
2319,ikeja,0 ikeja gra ikeja lagos,5,3,2,3,1,1,1,1,6,3500000
2320,ikeja,0 ikeja gra ikeja lagos,11,6,5,6,1,1,0,1,10,6200000
2321,ikeja,0 ikeja gra ikeja lagos,7,4,3,4,1,1,0,1,8,4000000
2322,ikeja," ikeja gra, ikeja lagos",7,4,3,4,0,0,0,1,8,3500000
2323,ikeja," salvation road, omega courts, opebi ikeja lagos",6,3,3,3,1,0,0,1,6,3200000
2324,ikeja,oladipupo kuku allen avenue ikeja lagos,8,4,4,4,0,0,0,1,8,3500000
2325,ikeja,mangoro ikeja lagos,9,5,4,5,0,0,0,0,9,3500000
2326,ikeja,0 ikeja gra ikeja lagos,11,6,5,6,1,1,0,1,10,6200000
2327,ikeja,ikeja toyin street ikeja lagos,2,1,1,1,0,0,0,0,2,400000
2328,ikeja,.. opebi ikeja lagos,5,3,2,3,0,0,0,1,6,1500000
2329,ikeja,off allen avenue ikeja lagos,7,4,3,4,0,0,0,0,8,2000000
2330,ikeja,. ikeja gra ikeja lagos,5,3,2,3,1,1,1,1,6,3500000
2331,ikeja,awuse estate opebi ikeja lagos,7,4,3,4,1,1,0,1,8,4000000
2332,ikeja,0 ikeja gra ikeja lagos,11,6,5,6,1,1,0,1,10,6200000
2333,ikeja,. ikeja gra ikeja lagos,5,3,2,3,1,1,1,1,6,3500000
2334,ikeja,omole phase 2 ikeja lagos,6,3,3,3,0,0,0,1,6,2000000
2335,ikeja,opebi ikeja lagos,10,5,5,5,0,0,0,0,9,3500000
2336,ikeja,0 ikeja gra ikeja lagos,7,4,3,4,1,1,0,1,8,4000000
2337,ikeja,toyin street ikeja lagos,10,5,5,5,0,0,0,0,9,3500000
2338,ikeja,ikeja lagos,6,3,3,3,0,0,0,1,6,2500000
2339,ikeja,1 ikeja gra ikeja lagos,9,5,4,5,1,1,0,1,9,5500000
2340,ikeja,ikeja gra ikeja lagos,10,5,5,5,1,1,0,1,9,5500000
2341,ikeja,alausa ikeja lagos,6,3,3,3,1,1,1,1,6,3500000
2342,ikeja,0 ikeja gra ikeja lagos,9,5,4,5,0,0,0,1,9,5000000
2343,ikeja,toyin street ikeja lagos,6,3,3,3,0,0,0,0,6,1400000
2344,ikeja,.. adeniyi jones ikeja lagos,2,1,1,1,0,0,0,0,2,400000
2345,ikeja,- allen avenue ikeja lagos,6,3,3,3,1,0,0,1,6,3000000
2346,ikeja,toyin street ikeja lagos,8,4,4,4,0,0,0,0,8,2000000
2347,ikeja,akira estate adeniyi jones ikeja lagos,8,4,4,4,1,1,0,1,8,4000000
2348,ikeja,adeniyi jones ikeja adeniyi jones ikeja lagos,2,1,1,1,0,0,0,1,2,600000
2349,ikeja,"51 oluwaleimu street, allen avenue allen avenue ikeja lagos",7,4,3,4,0,0,0,1,8,3000000
2350,ikeja," oluwaleimu street, allen allen avenue ikeja lagos",7,4,3,4,0,0,0,1,8,3000000
2351,ikeja,"51 oluwaleimu street, allen avenue allen avenue ikeja lagos",7,4,3,4,0,0,0,1,8,3000000
2352,ikeja,ikeja gra ikeja lagos,8,4,4,4,1,1,0,1,8,4000000
2353,ikeja,alfred gardens estate oregun ikeja lagos,10,5,5,5,0,0,0,1,9,5000000
2354,ikeja," opic, isheri north, ikeja lagos",7,4,3,4,0,0,0,0,8,2000000
2355,ikeja," olanrewaju street off billing sway ,oregun oregun ikeja lagos",3,2,1,2,0,0,0,0,5,800000
2356,ikeja,obawole off ogba ikeja lagos,6,3,3,3,0,0,0,0,6,900000
2357,ikeja,obawole off ogba ikeja lagos,6,3,3,3,0,0,0,0,6,900000
2358,ikeja," ikeja gra, ikeja lagos",9,5,4,5,1,1,0,1,9,5500000
2359,ikeja,off allen avenue ikeja allen avenue ikeja lagos,4,2,2,2,1,0,0,1,5,1300000
2360,ikeja," off ayo-alabi street oke-ira, ogba ikeja lagos",6,3,3,3,0,0,0,0,6,900000
2361,ikeja,ogba ikeja lagos,7,4,3,4,0,0,0,0,8,2000000
2362,ikeja," ikeja gra, ikeja gra ikeja lagos",9,5,4,5,0,0,0,0,9,3500000
2363,ikeja,millennium estate ikeja gra ikeja lagos,7,4,3,4,1,1,0,1,8,4000000
2364,ikeja,off adeniyi jones . ikeja adeniyi jones ikeja lagos,8,4,4,4,1,1,0,1,8,4000000
2365,ikeja,estate off adeniyi jones adeniyi jones ikeja lagos,11,6,5,6,1,1,0,1,10,6200000
2366,ikeja,alfred garden oregun oregun ikeja lagos,6,3,3,3,1,1,1,1,6,3500000
2367,ikeja,olaiya street alausa ikeja lagos,4,2,2,2,0,0,0,0,5,900000
2368,ikeja,adeniyi jones ikeja adeniyi jones ikeja lagos,7,4,3,4,0,0,0,0,8,2000000
2369,ikeja,adeniyi jones adeniyi jones ikeja lagos,9,5,4,5,0,0,0,0,9,3500000
2370,ikeja,sslvation opebi ikeja lagos,4,2,2,2,1,1,1,1,5,1700000
2371,ikeja,ajisafe ikeja gra ikeja lagos,9,5,4,5,1,1,0,1,9,5500000
2372,ikeja,omole phase 2 lagos ikeja lagos,5,3,2,3,0,0,0,0,6,1100000
2373,ikeja,"oshorun estate, opic, isheri north content from nigeria property centre read more at: https://nigeriapropertycentre.com/for-rent/houses/detached-duplexes/lagos/isheri-north/opic/591137-top-notch-and-newly-built-4-bedroom-duplex ikeja lagos",9,5,4,5,0,0,0,0,9,3500000
2374,ikeja,117 opebi road ikeja agungi lekki lagos,3,2,1,2,0,0,0,1,5,1200000
2375,ikeja," magodo, gra, magodo ikeja lagos",6,3,3,3,0,0,0,1,6,1800000
2376,ikeja,"otedola estate, omole phase 2, ikeja lagos",7,4,3,4,0,0,0,0,8,2000000
2377,ikeja,off oduduwa way ikeja gra ikeja lagos,10,5,5,5,1,1,0,1,9,5500000
2378,ikeja,omole phase 2 ikeja lagos,7,4,3,4,0,0,0,0,8,2000000
2379,ikeja," salvation road after wema bank, omega courts, opebi ikeja lagos",10,5,5,5,0,0,0,0,9,4800000
2380,ikeja," ikeja gra, ikeja gra ikeja lagos",9,5,4,5,1,1,0,1,9,5500000
2381,ikeja,adeniyi jones adeniyi jones ikeja lagos,9,5,4,5,1,1,0,1,9,5500000
2382,ikeja,7 ajisafe street ikeja g.r.a ikeja gra ikeja lagos,5,3,2,3,1,0,0,1,6,3000000
2383,ikeja,8&10 shonny highway shonibare estate maryland maryland ikeja lagos,4,2,2,2,1,1,1,1,5,2200000
2384,ikeja,adeniyi jones ikeja lagos,7,4,3,4,0,0,0,0,8,2000000
2385,ikeja,isaac john ikeja gra ikeja lagos,2,1,1,1,1,1,1,1,2,1000000
2386,ikeja,ikeja gra ikeja gra ikeja lagos,5,3,2,3,1,1,1,1,6,3500000
2387,ikeja,oladipo bateye street ikeja gra ikeja lagos,9,5,4,5,0,0,0,1,9,5000000
2388,ikeja,off allen allen avenue ikeja lagos,7,4,3,4,1,1,0,1,8,4000000
2389,ikeja,oba ladejobi ikeja gra ikeja lagos,12,6,6,6,1,1,0,1,10,6200000
2390,ikeja,"24 oba akinjobi way, ikeja, gra, lagos, ikeja gra, ikeja, lagos ikeja gra ikeja lagos",5,3,2,3,1,1,1,1,6,3500000
2391,ikeja,opebi road ikeja opebi ikeja lagos,7,4,3,4,0,0,0,0,8,2000000
2392,ikeja," shonny str, shonibare estate maryland ikeja mobolaji bank anthony way ikeja lagos",8,5,3,5,0,0,0,0,9,3500000
2393,ikeja,shonibare estate mobolaji bank anthony way ikeja lagos,11,6,5,6,0,0,0,0,10,4700000
2394,ikeja,orileyimu str off allen allen avenue ikeja lagos,2,1,1,1,0,0,0,0,2,450000
2395,ikeja," emeka anyaoku millennium estate, muiz banire street, ikeja gra ikeja gra ikeja lagos",9,5,4,5,0,0,0,0,9,3500000
2396,ikeja," afariogun street, off awolowo way, ikeja, lagos obafemi awolowo way ikeja lagos",4,2,2,2,0,0,0,0,5,800000
2397,iyana ipaja,peace est aboru iyana ipaja lagos pipeline alimosho lagos,7,4,3,4,0,0,0,0,3,500000
2398,iyana ipaja,an estate inside aboru iyana ipaja lagos alimosho lagos,6,3,3,3,0,0,0,1,2,500000
2399,iyana ipaja,t alimosho lagos,4,2,2,2,0,0,0,0,1,250000
2400,iyana ipaja,hilltop estate iyana ipaja lagos pipeline alimosho lagos,4,2,2,2,0,0,0,1,1,400000
2401,iyana ipaja,peace avenue evergreen est aboru iyana ipaja lagos alimosho lagos,6,3,3,3,0,0,0,0,2,400000
2402,iyana ipaja,iyana ipaja ipaja lagos,5,3,2,3,1,1,0,1,2,550000
2403,iyana ipaja,prime garden estate aboru iyana ipaja ipaja lagos,6,3,3,3,1,1,0,1,2,550000
2404,iyana ipaja,iyana paja road iyana ipaja ipaja lagos,8,4,4,4,1,1,0,1,3,650000
2405,iyana ipaja,prime garden estate iyana paja iyana ipaja ipaja lagos,8,4,4,4,0,0,0,0,3,500000
2406,iyana ipaja," command, ikola road. iyana ipaja ipaja lagos",5,3,2,3,0,0,0,0,2,400000
2407,iyana ipaja,pleasure iyana ipaja ipaja lagos,6,3,3,3,0,0,0,1,2,500000
2408,iyana ipaja,aboru iyana ipaja ipaja lagos,6,3,3,3,0,0,0,1,2,500000
2409,iyana ipaja,iyana ipaja aboru egbeda alimosho lagos,2,1,1,1,0,0,0,1,1,150000
2410,iyana ipaja,ishola okosule inside aboru iyana ipaja lagos pipeline alimosho lagos,2,1,1,1,0,0,0,0,1,90000
2411,iyana ipaja,iyana ipaja aboru egbeda alimosho lagos,2,1,1,1,0,0,0,1,1,150000
2412,iyana ipaja,iyana ipaja aboru egbeda alimosho lagos,6,3,3,3,0,0,0,0,2,300000
2413,iyana ipaja,governors road alimosho iyana-ipaja extension egbeda alimosho lagos,2,1,1,1,1,1,1,1,1,250000
2414,iyana ipaja,hitop estate alimosho iyana-ipaja extension egbeda alimosho lagos,2,1,1,1,0,0,0,1,1,150000
2415,iyana ipaja,iyana ipaja ipaja lagos,4,2,2,2,0,0,0,0,1,300000
2416,iyana ipaja,iyana ipaja ipaja lagos,4,2,2,2,0,0,0,1,1,400000
2417,iyana ipaja,aboru iyana ipaja ipaja lagos,4,2,2,2,1,1,0,1,1,500000
2418,iyana ipaja,iyana ipaja ipaja lagos,7,4,3,4,1,1,0,1,3,650000
2419,iyana ipaja,iyana ipaja ipaja lagos,4,2,2,2,0,0,0,0,1,350000
2420,iyana ipaja,iyana ipaja ipaja lagos,4,2,2,2,1,1,1,1,1,550000
2421,iyana ipaja,iyana ipaja ipaja lagos,4,2,2,2,0,0,0,1,1,400000
2422,iyana ipaja,iyana ipaja ipaja lagos,4,2,2,2,1,1,0,1,1,500000
2423,iyana ipaja,hiltop estate iyana ipaja lagos alimosho lagos,4,2,2,2,0,0,0,1,1,450000
2424,iyana ipaja,pipeline alimosho lagos,7,4,3,4,1,1,0,1,3,650000
2425,iyana ipaja,iyana ipaja ipaja lagos,4,2,2,2,1,1,1,1,1,550000
2426,iyana ipaja,orile agege agege lagos,9,5,4,5,1,1,0,1,5,1200000
2427,iyana ipaja,prime estate iyana ipaja ipaja lagos,6,3,3,3,1,1,1,1,2,650000
2428,iyana ipaja," prime garden estate,aboru iyana ipaja . alimosho lagos",7,4,3,4,1,1,0,1,3,650000
2429,iyana ipaja,an estate inside aboru iyana ipaja alimosho lagos,6,3,3,3,0,0,0,1,2,500000
2430,iyana ipaja,hilltop estate iyana ipaja lagos alimosho lagos,4,2,2,2,0,0,0,1,1,400000
2431,iyana ipaja,"plot 350, wilson emelike street, hilltop estate aboru, iyana-ipaja egbeda alimosho lagos",2,1,1,1,1,1,1,1,1,300000
2432,yaba,adekunle yaba lagos,7,4,3,4,1,0,0,1,6,1800000
2433,yaba,onike yaba lagos,9,5,4,5,0,0,0,1,8,3000000
2434,yaba,adekunle yaba lagos,2,1,1,1,0,0,0,0,2,350009
2435,yaba,moore road sabo yaba lagos,7,4,3,4,1,1,1,1,6,2500000
2436,yaba,borno way adekunle yaba lagos,16,8,8,8,1,1,0,1,9,4000000
2437,yaba,carter adekunle yaba lagos,7,4,3,4,1,0,0,1,6,1800000
2438,yaba,brown akoka yaba lagos,5,3,2,3,0,0,0,1,5,1200000
2439,yaba,zanzi estate yaba lagos,7,4,3,4,0,0,0,1,6,1500000
2440,yaba,ogungbamila akoka yaba lagos,2,1,1,1,1,0,0,1,2,500000
2441,yaba,"  morroco, waec area. yaba lagos",6,3,3,3,0,0,0,1,5,1000000
2442,yaba,"  folaagoro road, yaba, lagos. fola agoro yaba lagos",11,6,5,6,1,1,0,1,8,3000000
2443,yaba,queens street alagomeji yaba lagos,6,3,3,3,1,1,1,1,5,1800000
2444,yaba,in a secute & gated estate in yaba. yaba lagos,8,4,4,4,0,0,0,1,6,1500000
2445,yaba,"  off commercial avenue, sabo, yaba. sabo yaba lagos",7,4,3,4,1,0,0,1,6,1800000
2446,yaba,"  off queens street, alagomeji, yaba alagomeji yaba lagos",6,3,3,3,1,1,1,1,5,1800000
2447,yaba,"  in a serene & gated estate in onike, yaba. onike yaba lagos",9,5,4,5,0,0,0,0,8,2000000
2448,yaba,"  commercial avenue, sabo, yaba. sabo yaba lagos",7,4,3,4,1,1,1,1,6,2500000
2449,yaba,"  off commercial avenue, sabo, yaba. sabo yaba lagos",5,3,2,3,1,1,1,1,5,1500000
2450,yaba,"  off hebert macaulay way, alagomeji, yaba. alagomeji yaba lagos",6,3,3,3,1,1,1,1,5,1500000
2451,yaba,"  off hebert macaulay way, adekunle, yaba. adekunle yaba lagos",7,4,3,4,0,0,0,0,6,1300000
2452,yaba,in a serene & gated estate onike yaba lagos,7,4,3,4,0,0,0,0,6,1300000
2453,yaba,"  olonade street, alagomeji, yaba. alagomeji yaba lagos",7,4,3,4,0,0,0,1,6,1500000
2454,yaba,off onike roundabout onike yaba lagos,6,3,3,3,1,0,0,1,5,1300000
2455,yaba,sabo yaba lagos,8,4,4,4,0,0,0,0,6,1400000
2456,yaba,akoka yaba lagos,2,1,1,1,1,1,1,1,2,600000
2457,yaba,sabo yaba sabo yaba lagos,9,5,4,5,0,0,0,0,8,2500000
2458,yaba,queen street alagomeji yaba lagos,2,1,1,1,1,1,1,1,2,600000
2459,yaba,ozone sabo yaba lagos,6,3,3,3,1,1,1,1,5,1500000
2460,yaba,in an estate onike yaba lagos,7,4,3,4,0,0,0,1,6,1500000
2461,yaba,off fola agoro abule ijesha yaba lagos,4,2,2,2,0,0,0,1,3,700000
2462,yaba,off chemist busstop akoka yaba lagos,7,4,3,4,0,0,0,0,6,1200000
2463,yaba,onike onike yaba lagos,7,4,3,4,0,0,0,1,6,1500000
2464,yaba,off pako busstop akoka yaba lagos,2,1,1,1,1,1,1,1,2,600000
2465,yaba,akoka yaba lagos,2,1,1,1,0,0,0,0,2,400000
2466,yaba,off herbert macaulay ebute metta yaba lagos,2,1,1,1,1,0,0,1,2,500000
2467,yaba,sabo yaba lagos,2,1,1,1,0,0,0,0,2,300000
2468,yaba,fola agoro road fola agoro yaba lagos,11,6,5,6,1,1,0,1,8,3000000
2469,yaba,silvercrest estate onike yaba lagos,10,5,5,5,1,0,0,1,8,3200000
2470,yaba,off herbert macaulay way yaba lagos,7,4,3,4,1,0,0,1,6,1800000
2471,yaba,chemist area akoka yaba lagos,2,1,1,1,1,0,0,1,2,500000
2472,yaba,sabo yaba lagos,9,5,4,5,0,0,0,1,8,3000000
2473,yaba,bickersteth estate onike yaba lagos,9,5,4,5,0,0,0,0,8,2000000
2474,yaba,tejuosho tejuosho yaba lagos,4,2,2,2,0,0,0,1,3,700000
2475,yaba,akoka yaba lagos,4,2,2,2,0,0,0,1,3,700000
2476,yaba,ebute metta yaba lagos,6,3,3,3,0,0,0,1,5,1200000
2477,yaba,tejuosho yaba lagos,2,1,1,1,0,0,0,0,2,400000
2478,yaba,ozone environment sabo yaba lagos,7,4,3,4,1,1,1,1,6,2000000
2479,yaba,heliconia court jibowu yaba lagos,7,4,3,4,1,1,1,1,6,2500000
2480,yaba,.. adekunle yaba lagos,8,4,4,4,1,1,1,1,6,2000000
2481,yaba,off onike roundabout onike yaba lagos,4,2,2,2,1,1,0,1,3,850000
2482,yaba,roundabout onike yaba lagos,2,1,1,1,0,0,0,0,2,300000
2483,yaba,monsuro abule oja yaba lagos,2,1,1,1,0,0,0,0,2,380000
2484,yaba,adekunle street adekunle yaba lagos,4,2,2,2,0,0,0,0,3,500000
2485,yaba,close to costain ebute metta yaba lagos,6,3,3,3,0,0,0,0,5,800000
2486,yaba,off herbert macaulay way alagomeji yaba lagos,4,2,2,2,1,0,0,1,3,800000
2487,yaba,off queens street alagomeji yaba lagos,2,1,1,1,0,0,0,0,2,400000
2488,yaba,akoka yaba lagos,2,1,1,1,1,1,1,1,2,600000
2489,yaba,onike yaba lagos,2,1,1,1,1,0,0,1,2,500000
2490,yaba,yaba adekunle yaba lagos,2,1,1,1,0,0,0,0,2,350000
2491,yaba,off fola agoro road yaba lagos yaba lagos,7,3,4,3,0,0,0,1,5,1000000
2492,yaba,akoka akoka yaba lagos,2,1,1,1,1,0,0,1,2,500000
2493,yaba,adekule adekunle yaba lagos,2,1,1,1,0,0,0,0,2,350000
2494,yaba,onike yaba lagos,7,4,3,4,0,0,0,1,6,1500000
2495,yaba,onike yaba lagos,7,4,3,4,0,0,0,1,6,1500000
2496,yaba,adekunle yaba lagos,7,4,3,4,1,0,0,1,6,1800000
2497,yaba,akoka yaba lagos,4,2,2,2,0,0,0,1,3,700000
2498,yaba,.. akoka yaba lagos,5,3,2,3,0,0,0,0,5,900000
2499,yaba,akoka yaba lagos,2,1,1,1,1,1,1,1,2,600000
2500,yaba,onike yaba lagos,4,2,2,2,1,1,0,1,3,850000
2501,yaba,ebute meta east ebute metta yaba lagos,7,4,3,4,0,0,0,0,6,1200000
2502,yaba,morocco yaba lagos,6,3,3,3,0,0,0,1,5,1000000
2503,yaba,off cemetery road ebute metta yaba lagos,5,3,2,3,0,0,0,0,5,800000
2504,yaba,morocco yaba lagos,6,3,3,3,0,0,0,1,5,1000000
2505,yaba,ebute meta east ebute metta yaba lagos,2,1,1,1,0,0,0,0,2,350000
2506,yaba,helliconia court yaba gra yaba lagos,9,5,4,5,1,0,0,1,8,3200000
2507,yaba,ebute meta ebute metta yaba lagos,5,3,2,3,0,0,0,1,5,1000000
2508,yaba,ebute meta west ebute metta yaba lagos,5,3,2,3,0,0,0,1,5,1000000
2509,yaba,morocco yaba lagos,4,2,2,2,0,0,0,1,3,700000
2510,yaba,off herbert marcaulay way alagomeji yaba alagomeji yaba lagos,7,4,3,4,0,0,0,1,6,1500000
2511,yaba,alagomeji alagomeji yaba lagos,7,4,3,4,1,1,1,1,6,2000000
2512,yaba,old yaba road adekunle yaba lagos,3,2,1,2,1,0,0,1,3,800000
2513,yaba,- ebute metta yaba lagos,4,2,2,2,0,0,0,1,3,700000
2514,yaba,behind yabatech yaba lagos,5,3,2,3,0,0,0,1,5,1200000
2515,yaba,adekunle yaba lagos,7,4,3,4,1,0,0,1,6,1800000
2516,yaba,... akoka yaba lagos,7,4,3,4,0,0,0,1,6,1500000
2517,yaba,clegg yaba lagos,2,1,1,1,0,0,0,0,2,400000
2518,yaba,.. adekunle yaba lagos,7,4,3,4,1,1,1,1,6,2000000
2519,yaba," off community road, akoka very close to bariga , akoka yaba lagos",6,3,3,3,0,0,0,0,5,700000
2520,yaba,akoka yaba lagos,2,1,1,1,1,0,0,1,2,500000
2521,yaba,onike akoka yaba lagos,2,1,1,1,0,0,0,0,2,400000
2522,yaba,onike akoka yaba lagos,2,1,1,1,1,1,1,1,2,600000
2523,yaba,akoka akoka yaba lagos,7,4,3,4,0,0,0,0,6,1000000
2524,yaba,fola agoro yaba lagos,5,3,2,3,0,0,0,1,5,1000000
2525,yaba,in a serene & gated estate sabo yaba lagos,4,2,2,2,1,1,0,1,3,850000
2526,yaba,onike yaba lagos,7,4,3,4,0,0,0,0,6,1300000
2527,yaba,akoka yaba lagos,2,1,1,1,1,0,0,1,2,500000
2528,yaba," aderupoko street, iwaya iwaya yaba lagos",2,1,1,1,0,0,0,0,2,300000
2529,yaba,sabo yaba lagos,8,4,4,4,0,0,0,1,6,1600000
2530,yaba,yaba lagos,2,1,1,1,0,0,0,0,2,350000
2531,yaba,akoka akoka yaba lagos,4,2,2,2,0,0,0,0,3,650000
2532,yaba,akoka yaba akoka yaba lagos,6,3,3,3,0,0,0,1,5,1200000
2533,yaba,abule ijesha yaba abule ijesha yaba lagos,6,3,3,3,0,0,0,1,5,1000000
2534,yaba,abule ijesha yaba abule ijesha yaba lagos,6,3,3,3,0,0,0,1,5,1000000
2535,yaba,onike yaba onike yaba lagos,6,3,3,3,1,0,0,1,5,1300000
2536,yaba,onike sabo yaba onike yaba lagos,6,3,3,3,1,0,0,1,5,1300000
2537,yaba,onike sabo onike yaba lagos,6,3,3,3,1,0,0,1,5,1300000
2538,yaba,yaba lagos,4,2,2,2,1,1,1,1,3,1300000
2539,yaba,sabo yaba lagos,2,1,1,1,0,0,0,0,2,400000
2540,yaba,onike yaba lagos,2,1,1,1,1,0,0,1,2,500000
2541,yaba,onike yaba lagos,2,1,1,1,1,0,0,1,2,500000
2542,yaba,fola agoro yaba lagos,2,1,1,1,0,0,0,1,2,450000
2543,yaba,akoka yaba lagos,3,2,1,2,0,0,0,1,3,700000
2544,yaba,onike yaba lagos,2,1,1,1,1,0,0,1,2,500000
2545,yaba,onike yaba lagos,2,1,1,1,1,0,0,1,2,500000
2546,yaba,onike yaba lagos,2,1,1,1,1,0,0,1,2,500000
2547,yaba,yaba alagomeji yaba lagos,2,1,1,1,1,1,1,1,2,600000
2548,yaba,akoka yaba lagos,4,2,2,2,0,0,0,1,3,700000
2549,yaba,akoka yaba lagos,2,1,1,1,1,0,0,1,2,500000
2550,yaba,abule nla ebute metta yaba lagos,5,3,2,3,0,0,0,1,5,1000000
2551,yaba,onike yaba lagos,4,2,2,2,1,1,0,1,3,850000
2552,yaba,sabo yaba lagos,9,5,4,5,0,0,0,1,8,3000000
2553,yaba,close to adekunle ebute metta yaba lagos,2,1,1,1,0,0,0,0,2,350000
2554,yaba,sabo sabo yaba lagos,9,5,4,5,1,1,0,1,8,3500000
2555,yaba,yaba lagos,2,1,1,1,0,0,0,0,2,300000
2556,yaba,fola agoro fola agoro yaba lagos,7,4,3,4,1,0,0,1,6,1800000
2557,yaba,akoka yaba lagos,2,1,1,1,1,1,1,1,2,600000
2558,yaba,fola agoro yaba lagos,4,2,2,2,1,1,1,1,3,1300000
2559,yaba,.. akoka yaba lagos,7,4,3,4,0,0,0,1,6,1500000
2560,yaba,akoka yaba lagos,2,1,1,1,1,0,0,1,2,500000
2561,yaba,onike yaba lagos,2,1,1,1,0,0,0,1,2,450000
2562,yaba,iwaya yaba lagos,6,3,3,3,0,0,0,0,5,700000
2563,yaba,ebute metta yaba lagos,4,2,2,2,1,0,0,1,3,800000
2564,yaba,fola agoro yaba lagos,2,1,1,1,1,1,1,1,2,600000
2565,yaba,off fola-agoro yaba lagos yaba lagos,2,1,1,1,0,0,0,1,2,450000
2566,yaba,close to pako bus stop akoka yaba lagos,7,4,3,4,0,0,0,1,6,1500000
2567,yaba,morrocco axis jibowu yaba lagos,6,3,3,3,0,0,0,1,5,1000000
2568,yaba,onike onike yaba lagos,2,1,1,1,0,0,0,0,2,400000
2569,yaba,sabo yaba lagos,5,3,2,3,1,1,1,1,5,1500000
2570,yaba,a very clean 2br apartment at akoka extension 2t2b good packing space 550k akoka yaba lagos,4,2,2,2,0,0,0,0,3,550000
2571,yaba,tejuosho yaba lagos,4,2,2,2,0,0,0,0,3,500000
2572,yaba,chemist akoka yaba lagos,2,1,1,1,0,0,0,0,2,350000
2573,yaba,awofala street akoka yaba lagos,6,3,3,3,0,0,0,0,5,700000
2574,yaba,off bornu way adekunle yaba lagos,6,3,3,3,1,1,1,1,5,1800000
2575,yaba,close to pako bus stop akoka yaba lagos,2,1,1,1,0,0,0,0,2,400000
2576,yaba,off fola-agoro yaba lagos yaba lagos,2,1,1,1,0,0,0,1,2,450000
2577,yaba,fola agoro yaba lagos,2,1,1,1,0,0,0,0,2,300000
2578,yaba,- ebute metta yaba lagos,4,2,2,2,0,0,0,0,3,600000
2579,yaba,alagomeji yaba lagos,6,3,3,3,1,1,1,1,5,1800000
2580,yaba,.. onike yaba lagos,2,1,1,1,0,0,0,0,2,400000
2581,yaba," ebute meta west,. lagos state ebute metta yaba lagos",6,3,3,3,0,0,0,0,5,900000
2582,yaba,akoka akoka yaba lagos,7,4,3,4,0,0,0,0,6,1000000
2583,yaba,akoka yaba lagos,5,3,2,3,0,0,0,0,5,800000
2584,yaba,close to pako bus stop akoka yaba lagos,7,4,3,4,0,0,0,1,6,1500000
2585,yaba," ebute metta east, ebute metta yaba lagos",2,1,1,1,0,0,0,0,2,300000
2586,yaba,alagomeji yaba lagos,8,4,4,4,1,1,1,1,6,2000000
2587,yaba,close to adekunle ebute metta yaba lagos,6,3,3,3,1,0,0,1,5,1300000
2588,yaba,ebute metta yaba lagos,4,2,2,2,0,0,0,0,3,500000
2589,yaba,abule oja yaba lagos,2,1,1,1,0,0,0,0,2,380000
2590,yaba,moore road sabo yaba lagos,2,1,1,1,0,0,0,0,2,400000
2591,yaba,isaac john jibowu yaba lagos,6,3,3,3,0,0,0,1,5,1250000
2592,yaba,davies abule oja yaba lagos,2,1,1,1,1,0,1,1,2,550000
2593,yaba,close to pako bus stop akoka yaba lagos,2,1,1,1,0,0,0,0,2,400000
2594,yaba,akoka yaba lagos,7,4,3,4,0,0,0,0,6,1200000
2595,yaba,alagomeji alagomeji yaba lagos,7,4,3,4,1,1,1,1,6,2000000
2596,yaba,abule ijesha yaba lagos,2,1,1,1,0,0,0,0,2,400000
2597,yaba,onike yaba lagos,2,1,1,1,0,0,0,1,2,450000
2598,yaba,moore road sabo yaba lagos,2,1,1,1,0,0,0,0,2,400000
2599,yaba,off akoka akoka yaba lagos,2,1,1,1,0,0,0,0,2,300000
2600,yaba,abudu abule oja yaba lagos,2,1,1,1,0,0,0,0,2,400000
2601,yaba,off akoka akoka yaba lagos,2,1,1,1,0,0,0,0,2,300000
2602,yaba,.. sabo yaba lagos,7,4,3,4,0,0,0,0,6,1000000
2603,yaba,zanzi street onike yaba lagos,2,1,1,1,0,0,0,0,2,300000
2604,yaba,fola agoro yaba fola agoro yaba lagos,5,3,2,3,0,0,0,0,5,900000
2605,yaba,- fola agoro yaba lagos,6,3,3,3,0,0,0,1,5,1000000
2606,yaba,jibowu yaba lagos,3,1,2,1,1,1,1,1,2,600000
2607,yaba,akoka yaba lagos,2,1,1,1,1,1,1,1,2,600000
2608,yaba,yaba lagos,2,1,1,1,0,0,0,0,2,300000
2609,yaba,alara street onike yaba lagos,2,1,1,1,1,1,1,1,2,600000
2610,yaba,yaba lagos,6,3,3,3,1,1,1,1,5,1800000
2611,yaba,onike yaba lagos,2,1,1,1,0,0,0,1,2,450000
2612,yaba,akoka yaba lagos,7,4,3,4,0,0,0,0,6,1200000
2613,yaba,- onike yaba lagos,2,1,1,1,0,0,0,0,2,400000
2614,yaba,yaba lagos,6,3,3,3,1,0,0,1,5,1300000
2615,yaba,moroko yaba lagos,2,1,1,1,0,0,0,0,2,350000
2616,yaba,yaba lagos,6,3,3,3,1,1,1,1,5,1500000
2617,yaba,fola agoro yaba lagos,2,1,1,1,1,1,1,1,2,600000
2618,yaba,onike yaba lagos,2,1,1,1,0,0,0,1,2,450000
2619,yaba,ojuelegba axis tejuosho yaba lagos,2,1,1,1,0,0,0,0,2,400000
2620,yaba,.. fola agoro yaba lagos,6,3,3,3,1,1,1,1,5,1800000
2621,yaba,onike onike yaba lagos,3,1,2,1,1,1,1,1,2,600000
2622,yaba,akoka yaba lagos,4,2,2,2,1,0,0,1,3,800000
2623,yaba,akoka /bariga area akoka yaba lagos,5,3,2,3,0,0,0,0,5,700000
2624,yaba,close to pako bus stop akoka yaba lagos,2,1,1,1,1,1,1,1,2,600000
2625,yaba,fola agoro yaba lagos,4,2,2,2,1,0,0,1,3,800000
2626,yaba,off akoka akoka yaba lagos,6,3,3,3,0,0,0,0,5,700000
2627,yaba,- iwaya yaba lagos,6,3,3,3,0,0,0,0,5,800000
2628,yaba,jibowu yaba lagos,4,2,2,2,1,1,1,1,3,1300000
2629,yaba,harbert macaulay by jebba yaba lagos,2,1,1,1,0,0,0,0,2,350000
2630,yaba,ebutte metta ebute metta yaba lagos,4,2,2,2,1,1,1,1,3,1000000
2631,yaba,akoka yaba lagos,6,3,3,3,0,0,0,1,5,1000000
2632,yaba,yaba ebute east side. ebute metta yaba lagos,7,4,3,4,0,0,0,0,6,1300000
2633,yaba,akoka akoka yaba lagos,2,1,1,1,1,0,0,1,2,500000
2634,yaba,close to pako bus stop akoka yaba lagos,2,1,1,1,1,1,1,1,2,600000
2635,yaba,onike yaba lagos,2,1,1,1,0,0,0,1,2,450000
2636,yaba,alagomeji yaba lagos,7,4,3,4,0,0,0,1,6,1500000
2637,yaba,.. ebute metta yaba lagos,5,3,2,3,0,0,0,0,5,700000
2638,yaba," along unilag road, yaba lagos abule oja yaba lagos",2,1,1,1,0,0,0,0,2,400000
2639,yaba,adekunle yaba lagos,2,1,1,1,0,0,0,0,2,350000
2640,yaba,- onike yaba lagos,6,3,3,3,1,0,0,1,5,1300000
2641,yaba,fola agoro yaba lagos,2,1,1,1,0,0,0,1,2,450000
2642,yaba,old yaba road adekunle yaba lagos,7,4,3,4,1,0,0,1,6,1800000
2643,yaba,onike yaba lagos,3,2,1,2,0,0,0,0,3,600000
2644,yaba,akoka yaba lagos,4,2,2,2,0,0,0,0,3,600000
2645,yaba,yaba lagos,2,1,1,1,0,0,0,0,2,300000
2646,yaba,alagomeji yaba lagos,4,2,2,2,1,0,0,1,3,800000
2647,yaba,onike yaba lagos,2,1,1,1,0,0,0,1,2,450000
2648,yaba,yaba lagos,2,1,1,1,1,0,0,1,2,500000
2649,yaba,akoka akoka yaba lagos,2,1,1,1,1,0,0,1,2,500000
2650,yaba,adekunle adekunle yaba lagos,6,3,3,3,1,1,1,1,5,1800000
2651,yaba,akoka akoka yaba lagos,2,1,1,1,1,0,0,1,2,500000
2652,yaba,beside ilaje police station akoka yaba lagos,2,1,1,1,0,0,0,0,2,300000
2653,yaba,- akoka yaba lagos,3,2,1,2,0,0,0,0,3,500000
2654,yaba,akoka yaba lagos,5,3,2,3,0,0,0,0,5,700000
2655,yaba,yaba lagos,4,2,2,2,1,1,1,1,3,900000
2656,yaba," royal estate connal road, alagomeji yaba lagos",8,4,4,4,1,1,1,1,6,2500000
2657,yaba,onike yaba lagos,2,1,1,1,1,1,1,1,2,600000
2658,yaba,- sabo yaba lagos,4,2,2,2,1,1,1,1,3,1300000
2659,yaba,adekunle yaba adekunle yaba lagos,7,4,3,4,1,0,0,1,6,1800000
2660,yaba,close to pako bus stop akoka yaba lagos,2,1,1,1,0,0,0,0,2,400000
2661,yaba,brown street akoka yaba lagos,6,3,3,3,0,0,0,1,5,1200000
2662,yaba,adekunle yaba lagos,6,3,3,3,0,0,0,1,5,1000000
2663,yaba,akoka yaba lagos,5,3,2,3,0,0,0,0,5,900000
2664,yaba,- alagomeji yaba lagos,5,3,2,3,0,0,0,0,5,800000
2665,yaba,fola agoro fola agoro yaba lagos,7,4,3,4,1,0,0,1,6,1800000
2666,yaba,adekunle yaba lagos,7,4,3,4,1,0,0,1,6,1800000
2667,yaba,onike yaba lagos,2,1,1,1,0,0,0,0,2,400000
2668,yaba,akoka yaba lagos,4,2,2,2,0,0,0,1,3,700000
2669,yaba,yaba lagos,2,1,1,1,1,1,1,1,2,600000
2670,yaba,yaba lagos,2,1,1,1,1,1,1,1,2,600000
2671,yaba,yaba lagos,8,4,4,4,1,1,1,1,6,2500000
2672,yaba,yaba lagos,2,1,1,1,1,0,0,1,2,500000
2673,yaba,sabo yaba lagos,4,2,2,2,0,0,0,1,3,700000
2674,yaba,johnson onike yaba lagos,4,2,2,2,1,0,0,1,3,800000
2675,yaba,- jibowu yaba lagos,3,2,1,2,0,0,0,0,3,500000
2676,yaba,akoka yaba lagos,2,1,1,1,1,0,0,1,2,500000
2677,yaba,fola agoro yaba lagos,3,2,1,2,0,0,0,0,3,600000
2678,yaba,onike yaba lagos,2,1,1,1,0,0,0,1,2,450000
2679,yaba,fola agoro yaba lagos,5,3,2,3,0,0,0,0,5,900000
2680,yaba,jibowu yaba lagos,4,2,2,2,1,0,0,1,3,800000
2681,yaba,akoka akoka yaba lagos,4,2,2,2,0,0,0,1,3,700000
2682,yaba,em akoka yaba lagos,2,1,1,1,0,0,0,0,2,400000
2683,yaba,emily akoka yaba lagos,2,1,1,1,1,1,1,1,2,600000
2684,yaba," adjacent unilag,not far from hebert macaulay expressway akoka yaba lagos",4,2,2,2,0,0,0,0,3,500000
2685,yaba,off tejuosho road tejuosho yaba lagos,2,1,1,1,1,0,0,1,2,500000
2686,yaba,adjacent unilag akoka yaba lagos,2,1,1,1,1,1,1,1,2,600000
2687,yaba," grace court estate, off herbert macaulay way, adekunle yaba lagos",9,5,4,5,1,1,0,1,8,3500000
2688,yaba,makoko adekunle yaba lagos,2,1,1,1,0,0,0,0,2,380000
2689,yaba,akoka yaba lagos,2,1,1,1,1,0,1,1,2,550000
2690,yaba,onike yaba lagos,2,1,1,1,1,1,1,1,2,600000
2691,yaba,fola agoro fola agoro yaba lagos,2,1,1,1,0,0,0,0,2,350000
2692,yaba," akoka, akoka, akoka yaba lagos",2,1,1,1,0,0,0,0,2,300000
2693,yaba,western avenue by surulere jibowu yaba lagos,2,1,1,1,0,0,0,1,2,450000
2694,yaba,off iwaya road iwaya yaba lagos,4,2,2,2,1,0,0,1,3,800000
2695,yaba,akoka yaba lagos,7,4,3,4,0,0,0,0,6,1300000
2696,yaba,akoka yaba lagos,7,4,3,4,0,0,0,1,6,1500000
2697,gbagada,millenuim ups gbagada lagos,7,4,3,4,0,0,0,1,7,2300000
2698,gbagada,phase 2 gbagada lagos,9,5,4,5,1,1,0,1,8,3000000
2699,gbagada,... millenuim ups gbagada lagos,7,4,3,4,1,1,0,1,7,2500000
2700,gbagada,millenuim ups gbagada lagos,7,4,3,4,0,0,0,1,7,2300000
2701,gbagada,... millenuim ups gbagada lagos,7,4,3,4,1,1,0,1,7,2500000
2702,gbagada,ifako gbagada gbagada lagos,6,3,3,3,1,1,1,1,5,1400000
2703,gbagada,millenuim ups gbagada lagos,7,4,3,4,1,1,0,1,7,2500000
2704,gbagada,... millenuim ups gbagada lagos,5,3,2,3,1,1,1,1,5,1800000
2705,gbagada,glory estate ifako gbagada gbagada lagos,7,4,3,4,1,1,0,1,7,2500000
2706,gbagada,off ifako ifako gbagada gbagada lagos,4,2,2,2,0,0,0,0,3,700000
2707,gbagada,power line soluyi gbagada lagos,6,3,3,3,0,0,0,0,5,850000
2708,gbagada,ifako josland area ifako gbagada gbagada lagos,5,3,2,3,0,0,0,0,5,750000
2709,gbagada,sosanya soluyi gbagada lagos,5,3,2,3,0,0,0,0,5,850000
2710,gbagada,millenuim ups gbagada lagos,2,1,1,1,1,1,1,1,2,650000
2711,gbagada,medina gbagada lagos,7,4,3,4,0,0,0,0,7,1500000
2712,gbagada,alapere gbagada lagos,4,2,2,2,0,0,0,0,3,600000
2713,gbagada,phase 2 gbagada lagos,7,4,3,4,0,0,0,0,7,1500000
2714,gbagada,ifako ifako gbagada gbagada lagos,5,3,2,3,0,0,0,1,5,1000000
2715,gbagada,ifako gbagada gbagada lagos,4,2,2,2,0,0,0,1,3,800000
2716,gbagada,millenuim ups gbagada lagos,7,4,3,4,0,0,0,1,7,1800000
2717,gbagada,soluyi gbagada lagos,2,1,1,1,0,0,0,1,2,450000
2718,gbagada,pedro-gbagada area gbagada lagos,5,3,2,3,1,1,0,1,5,1300000
2719,gbagada,odo-eran iyana orowo gbagada oworonshoki gbagada lagos,5,3,2,3,0,0,0,0,5,700000
2720,gbagada,after deperlife church gbagada lagos,2,1,1,1,0,0,0,1,2,450000
2721,gbagada,sawmill gbagada gbagada lagos,5,3,2,3,0,0,0,0,5,900000
2722,gbagada,off pedro gbagada ifako gbagada gbagada lagos,5,3,2,3,0,0,0,1,5,1000000
2723,gbagada,"  community street ,odo eran,iyana oworo gbagada lagos",2,1,1,1,0,0,0,0,2,400000
2724,gbagada,gb millenuim ups gbagada lagos,7,4,3,4,1,1,0,1,7,2500000
2725,gbagada,pedro phase 1 gbagada lagos,6,3,3,3,0,0,0,0,5,850000
2726,gbagada,ifako gbagada gbagada lagos,5,3,2,3,0,0,0,1,5,1000000
2727,gbagada,ifako gbagada gbagada lagos,7,4,3,4,0,0,0,0,7,1300000
2728,gbagada,atunrase medina gbagada lagos,7,4,3,4,0,0,0,1,7,2000000
2729,gbagada,ifako gbagada gbagada lagos,5,3,2,3,1,1,1,1,5,1500000
2730,gbagada,millenuim ups gbagada lagos,7,4,3,4,0,0,0,0,7,1600000
2731,gbagada,millenuim ups gbagada lagos,7,4,3,4,0,0,0,1,7,2000000
2732,gbagada,ifako ifako gbagada gbagada lagos,7,4,3,4,0,0,0,1,7,2000000
2733,gbagada,ferano court ifako gbagada gbagada lagos,11,6,5,6,1,1,0,1,8,3000000
2734,gbagada,millennium estate millenuim ups gbagada lagos,7,4,3,4,1,1,0,1,7,2500000
2735,gbagada,millennium estate millenuim ups gbagada lagos,9,5,4,5,1,1,1,1,8,3500000
2736,gbagada,josodat estate soluyi gbagada lagos,7,4,3,4,0,0,0,0,7,1500000
2737,gbagada,ifako gbagada gbagada lagos,6,3,3,3,0,0,0,1,5,1000000
2738,gbagada,medina gbagada lagos,5,2,3,2,1,1,1,1,3,1300000
2739,gbagada,soluyi gbagada lagos,6,3,3,3,0,0,0,0,5,700000
2740,gbagada,ifako gbagada gbagada lagos,6,3,3,3,0,0,0,0,5,900000
2741,gbagada,akinwunmi ifako gbagada gbagada lagos,4,2,2,2,0,0,0,0,3,700000
2742,gbagada,ifako gbagada gbagada lagos,6,3,3,3,1,1,0,1,5,1300000
2743,gbagada,.. ifako gbagada gbagada lagos,6,3,3,3,0,0,0,0,5,800000
2744,gbagada,soluyi gbagada lagos,6,3,3,3,0,0,0,0,5,700000
2745,gbagada,gbagada road phase 2 gbagada lagos,2,1,1,1,1,1,0,1,2,500000
2746,gbagada,popoola soluyi gbagada lagos,6,3,3,3,1,0,0,1,5,1200000
2747,gbagada,yetunde brown ifako gbagada gbagada lagos,4,2,2,2,0,0,0,1,3,800000
2748,gbagada,medina gbagada lagos,6,3,3,3,1,1,0,1,5,1300000
2749,gbagada,sawmill ifako gbagada gbagada lagos,7,4,3,4,0,0,0,0,7,1100000
2750,gbagada,gbagada lagos,4,2,2,2,0,0,0,0,3,700000
2751,gbagada,soluyi gbagada lagos,6,3,3,3,0,0,0,0,5,900000
2752,gbagada,ifako gbagada gbagada lagos,6,3,3,3,0,0,0,1,5,1000000
2753,gbagada,millennium estate millenuim ups gbagada lagos,7,4,3,4,1,1,0,1,7,2500000
2754,gbagada,medina gbagada lagos,5,3,2,3,0,0,0,0,5,800000
2755,gbagada,pedro phase 1 gbagada lagos,8,4,4,4,0,0,0,1,7,2000000
2756,gbagada,gbagada extension ifako gbagada gbagada lagos,2,1,1,1,1,1,0,1,2,500000
2757,gbagada,soluyi gbagada lagos,2,1,1,1,0,0,0,1,2,450000
2758,gbagada,around mobil phase 2 gbagada lagos,3,2,1,2,0,0,0,0,3,650000
2759,gbagada,soluyi gbagada lagos,2,1,1,1,0,0,0,1,2,450000
2760,gbagada,medina gbagada lagos,4,2,2,2,0,0,0,1,3,800000
2761,gbagada,millenuim ups gbagada lagos,8,4,4,4,1,1,0,1,7,2500000
2762,gbagada,millennium estate ups gbagada millenuim ups gbagada lagos,7,4,3,4,0,0,0,0,7,1500000
2763,gbagada,soluyi gbagada lagos,6,3,3,3,1,0,0,1,5,1200000
2764,gbagada,- ifako gbagada gbagada lagos,4,2,2,2,1,0,0,1,3,900000
2765,gbagada,off ajayi aina in a close ifako gbagada gbagada lagos,7,4,3,4,0,0,0,0,7,1500000
2766,gbagada,soluyi gbagada lagos,5,3,2,3,0,0,0,0,5,900000
2767,gbagada,ifako gbagada gbagada lagos,2,1,1,1,0,0,0,1,2,450000
2768,gbagada,oke alo millenuim ups gbagada lagos,7,4,3,4,1,1,0,1,7,2500000
2769,gbagada,soluyi gbagada lagos,2,1,1,1,1,1,0,1,2,500000
2770,gbagada,millenuim ups gbagada lagos,7,4,3,4,1,1,0,1,7,2500000
2771,gbagada,millenuim ups gbagada lagos,7,4,3,4,1,1,0,1,7,2500000
2772,gbagada,millenuim ups gbagada lagos,8,4,4,4,1,1,0,1,7,2500000
2773,gbagada,ifako gbagada gbagada lagos,6,3,3,3,0,0,0,1,5,1000000
2774,gbagada,ifako gbagada gbagada lagos,6,3,3,3,0,0,0,1,5,1000000
2775,gbagada,millennium estate gbagada millenuim ups gbagada lagos,7,4,3,4,1,1,0,1,7,2500000
2776,gbagada,power line soluyi gbagada lagos,5,3,2,3,0,0,0,0,5,700000
2777,gbagada," off labake street, mayaki oworo, gbagada oworonshoki gbagada lagos",2,1,1,1,0,0,0,0,2,300000
2778,gbagada,off dehinde estate ifako gbagada ifako gbagada gbagada lagos,4,2,2,2,0,0,0,0,3,500000
2779,gbagada," off secretariat street, oworosoki, gbagada oworonshoki gbagada lagos",4,2,2,2,0,0,0,0,3,500000
2780,gbagada," off labake street, oworosoki, gbagada, lagos oworonshoki gbagada lagos",2,1,1,1,0,0,0,0,2,300000
2781,gbagada,oke alo millenuim ups gbagada lagos,7,4,3,4,0,0,0,0,7,1500000
2782,gbagada,oworonshoki gbagada lagos,7,4,3,4,0,0,0,0,7,1000000
2783,gbagada,ifako gbagada ifako gbagada gbagada lagos,7,4,3,4,0,0,0,0,7,1300000
2784,gbagada,gbagada phase one extension phase 1 gbagada lagos,5,3,2,3,0,0,0,1,5,1000000
2785,gbagada,chevron soluyi gbagada lagos,7,4,3,4,0,0,0,0,7,1200000
2786,gbagada,- gbagada lagos,2,1,1,1,1,1,1,1,2,700000
2787,gbagada,glory estate ifako gbagada gbagada lagos,7,4,3,4,1,1,0,1,7,2500000
2788,gbagada,- gbagada lagos,3,2,1,2,0,0,0,1,3,800000
2789,gbagada,medina gbagada lagos,5,3,2,3,0,0,0,0,5,800000
2790,gbagada,medina estate gbagada medina gbagada lagos,9,5,4,5,0,0,0,0,8,2500000
2791,gbagada,oke alo millennium estate gbagada millenuim ups gbagada lagos,7,4,3,4,1,1,0,1,7,2500000
2792,gbagada,shadia estate soluyi gbagada lagos,4,2,2,2,1,1,1,1,3,1000000
2793,gbagada,medina gbagada lagos,5,3,2,3,0,0,0,1,5,1000000
2794,gbagada," off williams street, gbagada ifako gbagada gbagada lagos",6,3,3,3,0,0,0,0,5,900000
2795,gbagada,atunrase atunrase medina gbagada lagos,5,3,2,3,0,0,0,1,5,1000000
2796,gbagada,sawmill ifako gbagada gbagada lagos,7,4,3,4,0,0,0,0,7,1200000
2797,gbagada,pefro gbagada lagos,6,4,2,4,0,0,0,0,7,1200000
2798,gbagada,millenuim ups gbagada lagos,7,4,3,4,1,1,0,1,7,2500000
2799,gbagada,josadat estate soluyi gbagada lagos,7,4,3,4,0,0,0,0,7,1500000
2800,gbagada,gbagada lagos,6,4,2,4,1,1,0,1,7,2500000
2801,gbagada,phase 2 gbagada lagos,9,5,4,5,1,1,0,1,8,3000000
2802,gbagada," off secretariat, street, oworosoki, gbagada oworonshoki gbagada lagos",4,2,2,2,0,0,0,0,3,500000
2803,gbagada,peace estate soluyi gbagada lagos,2,1,1,1,0,0,0,0,2,400000
2804,gbagada," off zainab crescent, medina estate gbagada atunrase medina gbagada lagos",7,4,3,4,0,0,0,0,7,1600000
2805,gbagada,millennium estate gbagada millenuim ups gbagada lagos,8,5,3,5,0,0,0,0,8,2700000
2806,gbagada,glory estate ifako gbagada gbagada lagos,7,4,3,4,0,0,0,1,7,2000000
2807,gbagada,powerline soluyi gbagada soluyi gbagada lagos,5,3,2,3,0,0,0,0,5,700000
2808,gbagada," off adio street, gbagada, newgarage, gbagada lagos new garage gbagada lagos",7,4,3,4,0,0,0,0,7,1000000
2809,gbagada,ifako gbagada gbagada lagos,5,3,2,3,0,0,0,1,5,1000000
2810,gbagada,soluyi gbagada lagos,5,3,2,3,0,0,0,1,5,1000000
2811,gbagada,ifako gbagada gbagada lagos,5,3,2,3,0,0,0,1,5,1000000
2812,gbagada,soluyi gbagada lagos,7,4,3,4,0,0,0,0,7,1200000
2813,gbagada,medina medina gbagada lagos,6,3,3,3,1,1,1,1,5,1500000
2814,gbagada,sholuyi soluyi gbagada lagos,4,2,2,2,0,0,0,0,3,700000
2815,gbagada,gbagada road phase 2 gbagada lagos,2,1,1,1,1,1,0,1,2,500000
2816,gbagada,poopola soluyi gbagada lagos,2,1,1,1,0,0,0,1,2,450000
2817,gbagada,millenuim ups gbagada lagos,5,3,2,3,1,1,1,1,5,1800000
2818,gbagada,soluyi gbagada lagos,5,3,2,3,0,0,0,0,5,700000
2819,gbagada,phase 2 gbagada lagos,2,1,1,1,1,1,0,1,2,500000
2820,gbagada,soluyi gbagada lagos,5,3,2,3,0,0,0,0,5,700000
2821,gbagada,gbagada lagos,8,4,4,4,0,0,0,0,7,1500000
2822,gbagada," millennium estate, millenuim ups gbagada lagos",7,4,3,4,0,0,0,0,7,1500000
2823,gbagada,gbagada lagos,6,3,3,3,0,0,0,0,5,700000
2824,gbagada,gbagada lagos,2,1,1,1,0,0,0,1,2,450000
2825,gbagada,gbagada lagos,6,3,3,3,1,1,1,1,5,1500000
2826,gbagada,charlie boy axis gbagada lagos,2,1,1,1,1,1,0,1,2,500000
2827,gbagada,gbagada lagos,6,3,3,3,1,0,0,1,5,1200000
2828,gbagada,soluyi gbagada lagos,4,2,2,2,0,0,0,0,3,700000
2829,gbagada,medina gbagada lagos,5,3,2,3,0,0,0,0,5,800000
2830,gbagada,gbagada phase 2 phase 2 gbagada lagos,2,1,1,1,1,1,0,1,2,500000
2831,gbagada,yetunde brown ifako gbagada gbagada lagos,2,1,1,1,1,1,0,1,2,500000
2832,gbagada,ifako gbagada gbagada lagos,2,1,1,1,0,0,0,1,2,450000
2833,gbagada,phase 2 gbagada lagos,7,4,3,4,0,0,0,0,7,1000000
2834,gbagada,estaport avenue soluyi gbagada lagos,2,1,1,1,1,1,0,1,2,500000
2835,gbagada,josodat estate soluyi gbagada lagos,10,5,5,5,0,0,0,0,8,2500000
2836,gbagada,soluyi gbagada lagos,8,4,4,4,0,0,0,0,7,1500000
2837,gbagada,soluyi gbagada lagos,6,3,3,3,1,0,0,1,5,1200000
2838,gbagada,jimoh bajulaye ifako gbagada gbagada lagos,6,3,3,3,1,0,0,1,5,1200000
2839,gbagada,phase 2 gbagada lagos,9,5,4,5,1,1,0,1,8,3000000
2840,gbagada,akinwunmi street ifako gbagada gbagada lagos,3,2,1,2,0,0,0,0,3,500000
2841,gbagada,ester port avenue soluyi gbagada lagos,2,1,1,1,1,1,0,1,2,500000
2842,gbagada,soluyi gbagada lagos,5,3,2,3,0,0,0,0,5,700000
2843,gbagada,millenuim ups gbagada lagos,6,3,3,3,1,1,1,1,5,1500000
2844,gbagada,gbagada ifako gbagada gbagada lagos,2,1,1,1,1,1,1,1,2,700000
2845,gbagada,soluyi gbagada lagos,6,3,3,3,0,0,0,0,5,700000
2846,gbagada,.. soluyi gbagada lagos,2,1,1,1,0,0,0,0,2,400000
2847,gbagada,phase 1 gbagada lagos,4,2,2,2,1,1,1,1,3,1200000
2848,gbagada,.. phase 2 gbagada lagos,5,3,2,3,0,0,0,1,5,1000000
2849,gbagada,soluyi soluyi gbagada lagos,5,3,2,3,0,0,0,0,5,700000
2850,gbagada,.. ifako gbagada gbagada lagos,6,3,3,3,0,0,0,0,5,900000
2851,gbagada,new garage gbagada lagos,4,2,2,2,0,0,0,1,3,750000
2852,gbagada,millennium estate gbagada millenuim ups gbagada lagos,7,4,3,4,1,1,0,1,7,2500000
2853,gbagada,- phase 1 gbagada lagos,7,4,3,4,0,0,0,0,7,1000000
2854,gbagada,estate medina gbagada lagos,2,1,1,1,0,0,0,0,2,300000
2855,gbagada,millenuim ups gbagada lagos,7,4,3,4,1,1,0,1,7,2500000
2856,gbagada,gbagada oke alo lagos. ifako gbagada gbagada lagos,6,3,3,3,1,1,1,1,5,1800000
2857,gbagada,atiku street soluyi gbagada lagos,4,2,2,2,0,0,0,0,3,650000
2858,gbagada,medina gbagada lagos,5,3,2,3,0,0,0,1,5,1000000
2859,gbagada,yetunde brown ifako gbagada gbagada lagos,5,3,2,3,0,0,0,1,5,1100000
2860,gbagada,deeper life axis ifako gbagada gbagada lagos,4,2,2,2,0,0,0,0,3,550000
2861,gbagada,millenuim ups gbagada lagos,7,4,3,4,0,0,0,0,7,1500000
2862,gbagada,new garage new garage gbagada lagos,5,3,2,3,0,0,0,0,5,750000
2863,gbagada,soluyi gbagada lagos,5,3,2,3,0,0,0,0,5,700000
2864,gbagada,after powerline bus stop soluyi gbagada lagos,5,3,2,3,0,0,0,0,5,700000
2865,gbagada,atunrase medina gbagada lagos,4,2,2,2,1,1,1,1,3,1000000
2866,gbagada,millenuim ups gbagada lagos,6,3,3,3,1,1,1,1,5,1500000
2867,gbagada,millennium estate millenuim ups gbagada lagos,7,4,3,4,0,0,0,0,7,1500000
2868,gbagada,phase 1 gbagada lagos,6,3,3,3,0,0,0,1,5,1000000
2869,gbagada,millenuim ups gbagada lagos,6,3,3,3,1,1,1,1,5,1500000
2870,gbagada,gbagada phase 1 gbagada lagos,2,1,1,1,1,1,1,1,2,600000
2871,gbagada,phase 2 gbagada lagos,5,3,2,3,1,1,0,1,5,1300000
2872,gbagada,phase 2 gbagada lagos,8,4,4,4,1,1,0,1,7,2500000
2873,gbagada,ifako ifako gbagada gbagada lagos,8,4,4,4,1,1,0,1,7,2500000
2874,gbagada,harmony estate ifako gbagada gbagada lagos,7,4,3,4,0,0,0,0,7,1300000
2875,gbagada,ogundele street ifako gbagada gbagada lagos,7,4,3,4,0,0,0,0,7,1200000
2876,gbagada,odo eran iyana oworo gbagada oworonshoki gbagada lagos,2,1,1,1,0,0,0,0,2,400000
2877,gbagada,phase 1 gbagada lagos,5,3,2,3,0,0,0,1,5,1000000
2878,gbagada,new garage gbagada lagos,5,3,2,3,0,0,0,0,5,850000
2879,gbagada,extension phase 2 gbagada lagos,6,3,3,3,1,0,0,1,5,1200000
2880,gbagada,millenuim ups gbagada lagos,7,4,3,4,1,1,0,1,7,2500000
2881,gbagada,sholuyi gbagada soluyi gbagada lagos,6,3,3,3,1,0,0,1,5,1200000
2882,gbagada,phase 2 gbagada lagos,4,2,2,2,0,0,0,0,3,650000
2883,gbagada,millenuim ups gbagada lagos,6,3,3,3,1,1,1,1,5,1500000
2884,gbagada,millenuim ups gbagada lagos,7,4,3,4,1,1,0,1,7,2500000
2885,gbagada,medina gbagada lagos,2,1,1,1,0,0,0,0,2,300000
2886,gbagada,new garage gbagada lagos,2,1,1,1,1,1,1,1,2,550000
2887,gbagada,sawmill gbagada lagos,4,2,2,2,1,0,0,1,3,900000
2888,gbagada,chevron road soluyi gbagada lagos,5,3,2,3,0,0,0,1,5,1000000
2889,gbagada,yetunde brown ifako gbagada gbagada lagos,7,4,3,4,0,0,0,0,7,1000000
2890,gbagada,soluyi gbagada lagos,2,1,1,1,0,0,0,0,2,300000
2891,gbagada,jesus street ifako gbagada gbagada lagos,7,4,3,4,0,0,0,0,7,1200000
2892,gbagada,soluyi gbagada lagos,7,4,3,4,0,0,0,0,7,1200000
2893,gbagada,soluyi soluyi gbagada lagos,5,3,2,3,0,0,0,0,5,700000
2894,gbagada,gbagada lagos,6,3,3,3,1,0,0,1,5,1200000
2895,gbagada,taodak estate ifako gbagada gbagada lagos,5,3,2,3,0,0,0,0,5,800000
2896,gbagada,williams street gbagada ifako gbagada gbagada lagos,5,3,2,3,0,0,0,0,5,700000
2897,gbagada,gbagada ph2 estate. phase 2 gbagada lagos,9,5,4,5,1,1,0,1,8,3000000
2898,gbagada,ifako gbagada ifako gbagada gbagada lagos,11,5,6,5,0,0,0,0,8,2500000
2899,gbagada,sawmill ifako ifako gbagada gbagada lagos,2,1,1,1,0,0,0,0,2,300000
2900,gbagada,ifako gbagada gbagada lagos,5,3,2,3,0,0,0,1,5,1000000
2901,gbagada,peace estate soluyi gbagada lagos,5,3,2,3,0,0,0,0,5,850000
2902,gbagada,gbagada lagos,5,2,3,2,1,1,1,1,3,1500000
2903,gbagada,deeper life church road soluyi gbagada lagos,2,1,1,1,0,0,0,0,2,300000
2904,gbagada,extension phase 2 gbagada lagos,4,2,2,2,1,1,1,1,3,1000000
2905,gbagada,new garage new garage gbagada lagos,5,3,2,3,0,0,0,0,5,750000
2906,gbagada,... soluyi gbagada lagos,5,3,2,3,1,1,0,1,5,1300000
2907,gbagada,millenuim ups gbagada lagos,6,3,3,3,1,1,1,1,5,1500000
2908,gbagada,close to uba in ifako gbagada ifako gbagada gbagada lagos,6,3,3,3,1,1,0,1,5,1300000
2909,gbagada,yetunde brown ifako gbagada gbagada lagos,7,4,3,4,0,0,0,0,7,1100000
2910,gbagada,gbagada lagos,6,3,3,3,1,1,1,1,5,1500000
2911,gbagada,gbagada lagos,6,3,3,3,1,1,1,1,5,1800000
2912,gbagada,ifako gbagada gbagada lagos,6,3,3,3,0,0,0,0,5,900000
2913,gbagada,sawmill ifako gbagada gbagada lagos,7,4,3,4,0,0,0,0,7,1000000
2914,gbagada,ajayi aina ifako gbagada gbagada lagos,6,3,3,3,1,1,1,1,5,1500000
2915,gbagada,atunrase medina gbagada lagos,5,3,2,3,0,0,0,1,5,1100000
2916,gbagada,jimoh bajulaye ifako gbagada gbagada lagos,6,3,3,3,1,0,0,1,5,1200000
2917,gbagada,phase 2 gbagada lagos,7,4,3,4,0,0,0,0,7,1500000
2918,gbagada,soluyi gbagada lagos,7,4,3,4,0,0,0,0,7,1200000
2919,gbagada,millenuim ups gbagada lagos,8,4,4,4,1,1,0,1,7,2500000
2920,gbagada,sawmill gbagada ifako gbagada gbagada lagos,4,2,2,2,0,0,0,1,3,800000
2921,gbagada,.. ifako gbagada gbagada lagos,7,4,3,4,1,1,0,1,7,2500000
2922,gbagada,new garage gbagada lagos,5,3,2,3,0,0,0,0,5,750000
2923,gbagada,deeper life axis ifako gbagada gbagada lagos,2,1,1,1,0,0,0,0,2,350000
2924,gbagada,millennium estate millenuim ups gbagada lagos,5,3,2,3,1,1,1,1,5,1800000
2925,gbagada,.. atunrase medina gbagada lagos,6,3,3,3,0,0,0,1,5,1000000
2926,gbagada,okealo millennium estate ifako gbagada gbagada lagos,6,3,3,3,1,1,1,1,5,1800000
2927,gbagada," millennium estate, oke-alo, gbagada lagos",8,4,4,4,1,1,0,1,7,2500000
2928,gbagada,soluyi gbagada lagos,7,4,3,4,0,0,0,0,7,1200000
2929,gbagada,gbagada oworoshoki junction oworonshoki gbagada lagos,5,3,2,3,0,0,0,0,5,700000
2930,gbagada,medina estate medina gbagada lagos,7,4,3,4,0,0,0,0,7,1500000
2931,gbagada,millenuim ups gbagada lagos,7,4,3,4,1,1,0,1,7,2500000
2932,gbagada,phase 2 gbagada lagos,10,5,5,5,1,1,0,1,8,3000000
2933,gbagada,gbagada lagos,5,3,2,3,0,0,0,0,5,700000
2934,gbagada,soluyi gbagada lagos,5,3,2,3,0,0,0,0,5,750000
2935,gbagada,odo eran iyana oworo gbagada oworonshoki gbagada lagos,5,3,2,3,0,0,0,0,5,700000
2936,gbagada,... millenuim ups gbagada lagos,7,4,3,4,1,1,0,1,7,2500000
2937,gbagada,hu medina gbagada lagos,5,3,2,3,0,0,0,0,5,800000
2938,gbagada,hu phase 2 gbagada lagos,6,3,3,3,0,0,0,0,5,900000
2939,gbagada,oworonshoki gbagada lagos,2,1,1,1,0,0,0,0,2,300000
2940,gbagada,millenuim ups gbagada lagos,6,3,3,3,0,0,0,1,5,1000000
2941,gbagada,glory estate ifako gbagada gbagada lagos,7,4,3,4,0,0,0,1,7,2000000
2942,gbagada,lagos ifako gbagada gbagada lagos,6,3,3,3,0,0,0,1,5,1000000
2943,gbagada,estate atunrase medina gbagada lagos,6,3,3,3,0,0,0,1,5,1000000
2944,gbagada,soluyi gbagada lagos,2,1,1,1,0,0,0,0,2,350000
2945,gbagada,peace estate soluyi gbagada lagos,2,1,1,1,0,0,0,0,2,300000
2946,gbagada,peace estate soluyi gbagada lagos,2,1,1,1,0,0,0,0,2,300000
2947,gbagada,off miyaki street oworonshoki gbagada lagos,3,2,1,2,0,0,0,0,3,500000
2948,gbagada,soluyi gbagada lagos,2,1,1,1,0,0,0,0,2,300000
2949,gbagada,jimoh oladenhinde gbagada lagos,3,2,1,2,1,1,1,1,3,1100000
2950,gbagada,peace estate sholuyi gbagada ifako gbagada gbagada lagos,7,4,3,4,0,0,0,0,7,1500000
2951,gbagada,adeyeye street millenuim ups gbagada lagos,6,3,3,3,1,1,1,1,5,1800000
2952,gbagada,oworonshoki gbagada lagos,2,1,1,1,0,0,0,0,2,350000
2953,ikorodu,beach road ebute ikorodu lagos,7,4,3,4,1,1,1,1,3,750000
2954,ikorodu,lowa estate jumofak ikorodu lagos,5,3,2,3,0,0,0,1,1,350000
2955,ikorodu,alogba estate ebute ikorodu lagos,7,4,3,4,0,0,0,1,3,600000
2956,ikorodu,"  kingsway estate, isawo agric ikorodu lagos",4,2,2,2,0,0,0,0,1,170000
2957,ikorodu,"  nasfat, isawo ikorodu ikorodu lagos",4,2,2,2,0,0,0,0,1,230000
2958,ikorodu,"  odunlami, isawo agric ikorodu lagos",2,1,1,1,1,1,0,1,1,150000
2959,ikorodu,"  kingsway estate, isawo agric agric ikorodu lagos",4,2,2,2,0,0,0,0,1,180000
2960,ikorodu,isawo isawo ikorodu lagos,7,4,3,4,0,0,0,0,3,400000
2961,ikorodu,ikorodu road(ilupeju) ilupeju lagos,2,1,1,1,1,1,1,1,1,300000
2962,ikorodu,ibeshe ibeshe ikorodu lagos,7,4,3,4,1,0,0,1,3,700000
2963,ikorodu,valley view estate ebute ikorodu lagos,7,4,3,4,0,0,0,1,3,600000
2964,ikorodu,grammar school ota ona ikorodu ikorodu lagos,5,3,2,3,0,0,0,0,1,200000
2965,ikorodu,valley view estate ebute ikorodu lagos,4,2,2,2,1,1,1,1,1,400000
2966,ikorodu,ebute ebute ikorodu lagos,3,2,1,2,0,0,0,1,1,250000
2967,ikorodu,isawo isawo ikorodu lagos,5,3,2,3,0,0,0,0,1,200000
2968,ikorodu,oba olaide estate ibeshe ikorodu lagos,4,2,2,2,1,0,1,1,1,350000
2969,ikorodu,elepe royal estate aga ebute ikorodu lagos,5,3,2,3,1,1,1,1,1,600000
2970,ikorodu,alogba estate ebute ikorodu lagos,4,2,2,2,1,0,1,1,1,350000
2971,ikorodu,ibeshe road ebute ikorodu lagos,5,3,2,3,1,1,1,1,1,650000
2972,ikorodu,isawo isawo ikorodu lagos,3,2,1,2,0,0,0,0,1,100000
2973,ikorodu,mowo kekere road ijede ikorodu lagos,2,1,1,1,1,1,0,1,1,150000
2974,ikorodu,lowa estate jumofak ikorodu lagos,5,3,2,3,1,0,0,1,1,400000
2975,ikorodu,dele kuti ebute ikorodu lagos,4,2,2,2,1,1,1,1,1,400000
2976,ikorodu,alogba estate ebute ikorodu lagos,5,3,2,3,1,1,1,1,1,500000
2977,ikorodu,beach road ebute ikorodu lagos,5,3,2,3,1,1,1,1,1,600000
2978,ikorodu,ibeshe road ebute ikorodu lagos,4,2,2,2,0,0,0,1,1,250000
2979,ikorodu,elepe royal estate aga ebute ikorodu lagos,5,3,2,3,1,1,1,1,1,650000
2980,ikorodu,olayinka jumbo ebute ikorodu lagos,9,5,4,5,1,1,0,1,4,800000
2981,ikorodu,"12 japheth omojuwa street, rabaka bus stop off. ibeshe ikorodu lagos",6,3,3,3,0,0,0,0,1,270000
2982,ikorodu,ijede road ijede ikorodu lagos,2,1,1,1,0,0,0,0,1,85000
2983,ikorodu,teachers quarters igbogbo ikorodu lagos,6,3,3,3,0,0,0,1,1,350000
2984,ikorodu," cele-gbaga area, itamaga ikorodu lagos",4,2,2,2,0,0,0,1,1,250000
2985,ikorodu,awesu bus stop igbogbo ikorodu lagos,7,4,3,4,0,0,0,0,3,400000
2986,ikorodu,by abuja bus stop off ibeshe road immediately after lagoon view estate agbowa ibeshe ikorodu lagos,5,3,2,3,1,0,1,1,1,450000
2987,ikorodu,oba laide estate off ibeshe road ibeshe ikorodu lagos,4,2,2,2,1,1,1,1,1,450000
2988,ikorodu,igbogbo ikorodu lagos,4,2,2,2,0,0,0,1,1,300000
2989,ikorodu,ikorodu lagos,5,3,2,3,0,0,0,1,1,350000
2990,ikorodu,erunwe/radio area ikorodu ikorodu lagos,8,4,4,4,0,0,0,1,3,600000
2991,ikorodu,ikorodu lagos,5,3,2,3,0,0,0,0,1,250000
2992,ikorodu,ikorodu lagos,6,3,3,3,1,0,0,1,1,400000
2993,ikorodu,ikorodu lagos,2,1,1,1,0,0,0,1,1,120000
2994,ikorodu,ikorodu lagos,2,1,1,1,1,1,1,1,1,200000
2995,ikorodu,ikorodu lagos,4,2,2,2,0,0,0,0,1,220000
2996,ikorodu,ikorodu lagos,4,2,2,2,0,0,0,1,1,250000
2997,ikorodu,ikorodu lagos,6,3,3,3,0,0,0,0,1,300000
2998,ikorodu,ikorodu lagos,4,2,2,2,0,0,0,1,1,250000
2999,ikorodu,chris kpapovwe street igbogbo ikorodu lagos,2,1,1,1,1,1,1,1,1,200000
3000,ikorodu,ikorodu garage ikorodu ikorodu lagos,2,1,1,1,0,0,0,0,1,110000
3001,ikorodu,unity bus stop igbogbo ikorodu lagos,5,3,2,3,0,0,0,0,1,250000
3002,ikorodu,ikorodu lagos,4,2,2,2,1,0,0,1,1,330000
3003,ikorodu,unity first gate igbogbo ikorodu lagos,2,1,1,1,0,0,0,1,1,130000
3004,ikorodu,ikorodu lagos,4,2,2,2,1,1,1,1,1,600000
3005,ikorodu,ikorodu lagos,2,1,1,1,1,1,1,1,1,220000
3006,ikorodu,ikorodu lagos,2,1,1,1,1,1,1,1,1,220000
3007,ikorodu,agunfoye last bus stop igbogbo ikorodu lagos,2,1,1,1,0,0,0,1,1,120000
3008,ikorodu,ikorodu lagos,4,2,2,2,0,0,0,1,1,250000
3009,ikorodu," korperate,macaulay igbogbo ikorodu lagos",2,1,1,1,0,0,0,0,1,100000
3010,ikorodu,maternity area igbogbo ikorodu lagos,5,3,2,3,0,0,0,0,1,200000
3011,ikorodu,lfi igbogbo ikorodu lagos,4,2,2,2,0,0,0,0,1,200000
3012,ikorodu,ikorodu lagos,6,3,3,3,1,1,1,1,1,500000
3013,ikorodu," behind cluster bar, off ebute igbogbo road, ebute ikorodu lagos",2,1,1,1,1,1,1,1,1,220000
3014,ikorodu,ikorodu lagos,4,2,2,2,0,0,0,0,1,200000
3015,ikorodu,ikorodu road shomolu lagos,7,4,3,4,1,1,1,1,3,1200000
3016,ikorodu,unity first gate(cole house) igbogbo ikorodu lagos,2,1,1,1,0,0,0,0,1,84000
3017,ikorodu," renecon road,macaulay str igbogbo ikorodu lagos",2,1,1,1,0,0,0,0,1,100000
3018,ikorodu,sikiru jimoh str igbogbo ikorodu lagos,2,1,1,1,1,1,0,1,1,150000
3019,ikorodu,chris kpakpovwe street igbogbo ikorodu lagos,5,3,2,3,0,0,0,0,1,200000
3020,ikorodu," iya folake str,macaulay igbogbo ikorodu lagos",3,2,1,2,0,0,0,0,1,120000
3021,ikorodu,igbe laara ikorodu ikorodu lagos,2,1,1,1,0,0,0,0,1,80000
3022,ikorodu,emily avenue igbogbo ikorodu lagos,2,1,1,1,0,0,0,0,1,80000
3023,ikorodu,orjih bus stop igbogbo ikorodu lagos,2,1,1,1,0,0,0,0,1,100000
3024,ikorodu,ikorodu lagos,4,2,2,2,1,1,1,1,1,450000
3025,ikorodu,emily avenue igbogbo ikorodu lagos,4,2,2,2,0,0,0,1,1,250000
3026,ikorodu,unity b/s bayeku road igbogbo ikorodu lagos,2,1,1,1,0,0,0,0,1,80000
3027,ikorodu,ikorodu lagos,6,3,3,3,1,0,0,1,1,400000
3028,ikorodu,fawole street igbogbo ikorodu lagos,5,3,2,3,0,0,0,0,1,200000
3029,ikorodu,selewu street igbogbo ikorodu lagos,2,1,1,1,0,0,0,0,1,84000
3030,ikorodu,teachers quarter selewu igbogbo igbogbo ikorodu lagos,2,1,1,1,0,0,0,1,1,120000
3031,ikorodu," owode-ibeshe, off ebute-ibeshe road ebute ikorodu lagos",3,2,1,2,1,1,1,1,1,400000
3032,ikorodu,ikorodu road shomolu lagos,7,4,3,4,1,1,1,1,3,1200000
3033,ikorodu,macaulay igbogbo ikorodu lagos,5,3,2,3,0,0,0,0,1,200000
3034,ikorodu,macaulay igbogbo ikorodu lagos,2,1,1,1,0,0,0,1,1,140000
3035,ikorodu,ikorodu lagos,2,1,1,1,0,0,0,0,1,100000
3036,ikorodu,emily avenue igbogbo ikorodu lagos,5,3,2,3,0,0,0,0,1,250000
3037,ikorodu,ekundayo street igbogbo ikorodu lagos,4,2,2,2,0,0,0,1,1,250000
3038,ikorodu,ikorodu lagos,4,2,2,2,1,1,1,1,1,450000
3039,ikorodu,teacher's quarter igbogbo ikorodu lagos,2,1,1,1,0,0,0,1,1,120000
3040,ikorodu,macaulay inside igbogbo ikorodu lagos,2,1,1,1,0,0,0,1,1,120000
3041,ikorodu,fawole bus stop igbogbo ikorodu lagos,2,1,1,1,0,0,0,0,1,80000
3042,ikorodu,elepe royal estate ebute ikorodu lagos,5,3,2,3,1,1,1,1,1,900000
3043,ikorodu,ajakaye street igbogbo ikorodu lagos,5,3,2,3,0,0,0,0,1,200000
3044,ikorodu,ogunlewe street igbogbo ikorodu lagos,2,1,1,1,1,1,0,1,1,150000
3045,ikorodu,ikorodu lagos,6,3,3,3,0,0,0,1,1,350000
3046,ikorodu," total light school,grammar school area ikorodu lagos",7,4,3,4,0,0,0,0,3,400000
3047,ikorodu,macaulay str igbogbo ikorodu lagos,2,1,1,1,0,0,0,0,1,80000
3048,ikorodu,ekundayo street igbogbo ikorodu lagos,2,1,1,1,0,0,0,0,1,80000
3049,ikorodu,ikorodu lagos,4,2,2,2,1,1,1,1,1,600000
3050,ikorodu,ikorodu lagos,2,1,1,1,1,1,1,1,1,200000
3051,ikorodu,lfi igbogbo ikorodu lagos,3,2,1,2,0,0,0,0,1,150000
3052,ikorodu,selewu street igbogbo ikorodu lagos,2,1,1,1,0,0,0,0,1,84000
3053,ikorodu,teachers quarter selewu igbogbo igbogbo ikorodu lagos,2,1,1,1,0,0,0,1,1,120000
3054,ikorodu,ikorodu lagos,4,2,2,2,0,0,0,1,1,250000
3055,ikorodu,ikorodu lagos,2,1,1,1,1,1,0,1,1,150000
3056,ikorodu,maternity right side igbogbo ikorodu lagos,3,2,1,2,0,0,0,0,1,130000
3057,ikorodu,maternity street igbogbo ikorodu lagos,5,3,2,3,0,0,0,0,1,200000
3058,ikorodu," korperate,macaulay igbogbo ikorodu lagos",2,1,1,1,0,0,0,0,1,80000
3059,ikorodu,ikorodu express rd ojota ojota ojota lagos,12,6,6,6,1,1,0,1,6,1500000
3060,ikorodu," offin, igbogbo igbogbo ikorodu lagos",4,2,2,2,0,0,0,0,1,200000
3061,ikorodu,harmony ebute ikorodu lagos,8,4,4,4,0,0,0,0,3,400000
3062,ikorodu,oga- oloye street igbogbo ikorodu lagos,4,2,2,2,0,0,0,0,1,150000
3063,ikorodu,"olarenwaju avenue, igbe laara, ikorodu. 08080763982 ikorodu ikorodu lagos",4,2,2,2,0,0,0,0,1,150000
3064,ikorodu," eleshin area, itamaga, ikorodu lagos",6,3,3,3,0,0,0,0,1,300000
3065,ikorodu,agunfoye beside lagos state model college igbogbo ikorodu lagos,7,4,3,4,0,0,0,0,3,400000
3066,ikorodu," patrick uzor street, agura ikorodu ikorodu ikorodu lagos",5,3,2,3,0,0,0,0,1,200000
3067,ikorodu," hilltop estate radio,itamaga ikorodu ikorodu lagos",2,1,1,1,1,1,0,1,1,150000
3068,ikorodu,"3, lead way drive igbolomu agric agric ikorodu lagos",4,2,2,2,0,0,0,0,1,150000
3069,ikorodu,1 keyolu street erunwen ikorodu lagos ikorodu ikorodu lagos,2,1,1,1,1,1,0,1,1,150000
3070,ikorodu,ebute road ikorodu lagos,4,2,2,2,0,0,0,1,1,300000
3071,ikorodu,ebute road ebute ikorodu lagos,6,3,3,3,1,1,1,1,1,600000
3072,ikorodu,alago off radio ikorodu ikorodu lagos,2,1,1,1,0,0,0,1,1,120000
3073,ikorodu,"2, oladogba street, opposite federal low cost housing estate. akasoleri. ikorodu -old ijebu ode road, after ile episode bus stop. ikorodu ikorodu lagos",3,2,1,2,0,0,0,0,1,180000
3074,ikorodu," nurudeen oyebola street,yusuf bus stop, selewu igbogbo ikorodu lagos",6,3,3,3,0,0,0,0,1,200000
3075,surulere,masha surulere lagos,5,3,2,3,1,1,1,1,5,1700000
3076,surulere,off adeniran ogunsanya adeniran ogunsanya surulere lagos,6,3,3,3,1,1,0,1,5,1500000
3077,surulere,raufu williams off adisa bashua street adelabu surulere lagos,8,4,4,4,1,1,1,1,6,3000000
3078,surulere,johnson street bode thomas surulere lagos,5,3,2,3,1,1,0,1,5,1500000
3079,surulere,bethel estate iponri iponri surulere lagos,9,5,4,5,0,0,0,0,8,3000000
3080,surulere,seriki street idi araba surulere lagos,5,3,2,3,0,0,0,0,5,700000
3081,surulere,benson street off akerele street ogunlana surulere lagos,6,3,3,3,1,1,0,1,5,1500000
3082,surulere,off cole street by olufemi street via ogunlana surulere lagos,7,4,3,4,0,0,0,0,6,1000000
3083,surulere,anjorin street off cole street via olufemi street ogunlana surulere lagos,6,3,3,3,1,1,0,1,5,1500000
3084,surulere,a serene environment off oyekan street ogunlana surulere lagos,9,5,4,5,1,1,0,1,8,3500000
3085,surulere,games village bode thomas surulere lagos,2,1,1,1,1,1,1,1,2,700000
3086,surulere,rasaq balogun street adeniran ogunsanya surulere lagos,4,2,2,2,1,1,1,1,4,1500000
3087,surulere,"  eric manuel crescent, off bode thomas street, surulere lagos bode thomas surulere lagos",8,4,4,4,1,0,1,1,6,2500000
3088,surulere,obele surulere lagos,2,1,1,1,0,0,0,1,2,500000
3089,surulere,kilo marsha surulere lagos,8,4,4,4,1,1,1,1,6,3000000
3090,surulere,lawanson surulere lagos,5,3,2,3,0,0,0,0,5,950000
3091,surulere,lawanson surulere lagos,7,4,3,4,0,0,0,1,6,1300000
3092,surulere,off cole street. lawanson surulere lagos,5,3,2,3,0,0,0,0,5,950000
3093,surulere,akinhanmi western avenue surulere lagos,2,1,1,1,1,1,1,1,2,700000
3094,surulere,bashiru agusto street bode thomas surulere lagos,4,2,2,2,1,0,1,1,4,1300000
3095,surulere,bamk olemoh ogunlana surulere lagos,4,2,2,2,0,0,0,0,4,700000
3096,surulere,simisola street ogunlana surulere lagos,2,1,1,1,1,1,1,1,2,700000
3097,surulere,ketu close aguda surulere lagos,5,3,2,3,0,0,0,0,5,750000
3098,surulere,- bode thomas surulere lagos,9,5,4,5,0,0,0,0,8,2500000
3099,surulere,back of luth idi araba surulere lagos,2,1,1,1,0,0,0,0,2,350000
3100,surulere,adekunle kuye street adelabu surulere lagos,5,3,2,3,0,0,0,1,5,1000000
3101,surulere,masha surulere lagos,6,3,3,3,0,0,0,1,5,1250000
3102,surulere,jalupon adeniran ogunsanya surulere lagos,9,5,4,5,0,0,0,1,8,3200000
3103,surulere,folawiyo bankole street masha surulere lagos,7,4,3,4,0,0,0,1,6,1500000
3104,surulere,off eloseh street adelabu surulere lagos,7,4,3,4,0,0,0,1,6,2000000
3105,surulere,ladipo labinjo bode thomas surulere lagos,12,6,6,6,1,1,0,1,8,3000000
3106,surulere,olayemi street off nnobi street by agboyin street adelabu surulere lagos,6,3,3,3,1,1,0,1,5,1500000
3107,surulere,cole street lawanson surulere lagos,6,3,3,3,0,0,0,0,5,700000
3108,surulere,kilo marsha surulere lagos,6,3,3,3,0,0,0,1,5,1200000
3109,surulere,adeniran ogunsanya surulere lagos,6,3,3,3,1,1,1,1,5,2000000
3110,surulere,... adeniran ogunsanya surulere lagos,4,2,2,2,1,1,1,1,4,1500000
3111,surulere,- western avenue surulere lagos,2,1,1,1,0,0,0,0,2,300000
3112,surulere,- masha surulere lagos,4,2,2,2,0,0,0,1,4,850000
3113,surulere,ogunlana surulere lagos,7,4,3,4,0,0,0,1,6,1300000
3114,surulere,off lawonson road lawanson surulere lagos,6,3,3,3,0,0,0,0,5,700000
3115,surulere,.. ogunlana surulere lagos,4,2,2,2,0,0,0,1,4,1000000
3116,surulere,obele ogunlana surulere lagos,4,2,2,2,0,0,0,0,4,800000
3117,surulere,ogunlana surulere lagos,2,1,1,1,0,0,0,0,2,350000
3118,surulere,western avenue surulere lagos,2,1,1,1,0,0,0,0,2,400000
3119,surulere,- western avenue surulere lagos,13,5,8,5,1,1,0,1,8,3500000
3120,surulere,.. adelabu surulere lagos,4,2,2,2,0,0,0,1,4,1000000
3121,surulere,ogunlana surulere lagos,2,1,1,1,0,0,0,1,2,500000
3122,surulere,ogunlana surulere lagos,6,3,3,3,0,0,0,1,5,1000000
3123,surulere,off ojuelegba road ojuelegba surulere lagos,2,1,1,1,0,0,0,0,2,400000
3124,surulere,adelabu surulere lagos,2,1,1,1,1,1,1,1,2,700000
3125,surulere,close to ojuelegba ojuelegba surulere lagos,2,1,1,1,0,0,0,1,2,500000
3126,surulere,off lawonson lawanson surulere lagos,2,1,1,1,0,0,0,0,2,400000
3127,surulere,kilo marsha surulere lagos,6,3,3,3,1,1,1,1,5,2000000
3128,surulere,ogunlana surulere lagos,2,1,1,1,1,1,1,1,2,700000
3129,surulere,akerele randle avenue surulere lagos,4,2,2,2,0,0,0,0,4,500000
3130,surulere,airways ijesha surulere lagos,2,1,1,1,0,0,0,0,2,350000
3131,surulere,airways ijesha surulere lagos,2,1,1,1,0,0,0,0,2,350000
3132,surulere," akinyele streeta off adekunle kuye,by adelabu surulere aguda surulere lagos",6,3,3,3,0,0,0,0,5,800000
3133,surulere,airways ijesha surulere lagos,2,1,1,1,0,0,0,0,2,350000
3134,surulere,off ogunlana drive ogunlana surulere lagos,6,3,3,3,1,1,0,1,5,1600000
3135,surulere,ishaga road itire surulere lagos,6,3,3,3,0,0,0,0,5,750000
3136,surulere,ishaga road itire surulere lagos,4,2,2,2,0,0,0,0,4,700000
3137,surulere," by akanbi crescent off aturashe , surulere lagos ojuelegba surulere lagos",7,4,3,4,0,0,0,0,6,1000000
3138,surulere,off cole street lawanson surulere lagos,6,3,3,3,0,0,0,0,5,950000
3139,surulere," ishaga road, via luth ojuelegba surulere lagos",2,1,1,1,0,0,0,0,2,300000
3140,surulere,idita bode thomas surulere lagos,2,1,1,1,1,1,1,1,2,700000
3141,surulere,off bode thomas bode thomas surulere lagos,2,1,1,1,1,1,1,1,2,700000
3142,surulere,karowi off oduduwa kilo kilo marsha surulere lagos,4,2,2,2,0,0,0,0,4,500000
3143,surulere,off ishaga road idi araba surulere lagos,6,3,3,3,0,0,0,0,5,700000
3144,surulere,lawanson surulere lawanson surulere lagos,7,4,3,4,0,0,0,1,6,1300000
3145,surulere,off cole street lawanson surulere lagos,6,3,3,3,0,0,0,0,5,950000
3146,surulere," off lawanson road, by zenith bank lawanson surulere lagos",4,2,2,2,0,0,0,0,4,500000
3147,surulere," by akanbi crescent off aturashe , surulere lagos ojuelegba surulere lagos",6,3,3,3,1,1,0,1,5,1500000
3148,surulere,adeniran ogunsanya adeniran ogunsanya surulere lagos,16,8,8,8,1,1,0,1,9,4000000
3149,surulere,sam-shonibare estate by olufemi off ogunlauna drive ogunlana surulere lagos,6,3,3,3,0,0,0,1,5,1000000
3150,surulere,- lawanson surulere lagos,7,4,3,4,0,0,0,0,6,1000000
3151,surulere,lawanson surulere lagos,6,3,3,3,0,0,0,0,5,700000
3152,surulere,off ishaga rd via (luth) surulere ojuelegba surulere lagos,4,2,2,2,1,1,1,1,4,1500000
3153,surulere,michael ogun street by ogunlauna junction by itere ogunlana surulere lagos,2,1,1,1,0,0,0,1,2,500000
3154,surulere,off masha masha surulere lagos,2,1,1,1,0,0,0,1,2,600000
3155,surulere,"119 ogunlana drive surulere, lagos ogunlana surulere lagos",5,3,2,3,0,0,0,1,5,1000000
3156,surulere,off aguda aguda surulere lagos,6,3,3,3,0,0,0,1,5,1000000
3157,surulere,anjorin street lawanson lawanson surulere lagos,6,3,3,3,0,0,0,1,5,1300000
3158,surulere,obele street lawanson surulere lagos,2,1,1,1,0,0,0,1,2,500000
3159,surulere,off ogunsanya bode thomas surulere lagos,7,4,3,4,1,1,1,1,6,2800000
3160,surulere,off ogunsanya bode thomas surulere lagos,5,3,2,3,1,1,1,1,5,2000000
3161,surulere,iseyin off adeshina ijesha surulere lagos,8,4,4,4,0,0,0,0,6,1000000
3162,surulere,ibudun western avenue surulere lagos,2,1,1,1,0,0,0,0,2,450000
3163,surulere,olufemi ogunlana surulere lagos,5,3,2,3,0,0,0,1,5,1300000