ID,Location,Specific Location,LocationID,Amenities,Bedroom,Bathroom,Toilet,New,Duplex,Luxury,Estate,Rank,Price
0,Ajah,"6, abimbola owodunni close, seaside estate, off badore road, ajah, lekki, lagos. badore ajah lagos",1,7,4,3,4,0,0,0,1,5,12600000
1,Ajah,badore ajah lagos,1,9,5,4,5,1,1,0,1,8,31500000
2,Ajah,lekki palm city ajah lagos,1,11,6,5,6,1,1,0,1,9,42000000
3,Ajah,- thomas estate ajah lagos,1,9,5,4,5,1,1,1,1,8,52500000
4,Ajah,ajah lagos,1,9,5,4,5,1,1,0,1,8,31500000
5,Ajah,allied garden estate badore ajah lagos,1,5,3,2,3,0,0,0,1,4,9450000
6,Ajah,silver point estate badore ajah lagos,1,5,3,2,3,0,0,0,1,4,9450000
7,Ajah,"  immediately after shoprite, sangotedo, lekki, lagos crown estate ajah lagos",1,9,5,4,5,1,1,0,1,8,31500000
8,Ajah,by general paint olokonla ajah lagos,1,7,4,3,4,1,1,1,1,5,26250000
9,Ajah,virgo estate badore ajah lagos,1,5,3,2,3,0,0,0,1,4,9450000
10,Ajah,unity estate badore ajah lagos,1,8,4,4,4,0,0,0,1,5,12600000
11,Ajah,marshyhill eatate ado ajah lagos,1,7,4,3,4,0,0,0,1,5,12600000
12,Ajah,happy land estate olokonla ajah lagos,1,9,5,4,5,1,1,0,1,8,31500000
13,Ajah,marshyhill estate ado ajah lagos,1,7,4,3,4,0,0,0,1,5,12600000
14,Ajah,inside estate badore ajah lagos,1,2,1,1,1,0,0,0,1,1,4200000
15,Ajah,badore ajah lagos,1,2,1,1,1,0,0,0,1,1,4200000
16,Ajah,- ado ajah lagos,1,2,1,1,1,0,0,0,1,1,4200000
17,Ajah,badore ajah lagos,1,3,2,1,2,1,1,0,1,4,8400000
18,Ajah,grenadine estate sangotedo ajah lagos,1,7,4,3,4,1,0,0,1,5,14700000
19,Ajah,"  grenadine estate, by shoprite sangotedo ajah lagos",1,7,4,3,4,1,1,1,1,5,17850000
20,Ajah,ado ajah lagos,1,7,4,3,4,1,0,0,1,5,14700000
21,Ajah,"  abijo gra, lekki, lagos abijo ajah lagos",1,14,6,8,6,1,1,0,1,9,42000000
22,Ajah,happy land estate olokonla ajah lagos,1,7,4,3,4,1,1,1,1,5,21000000
23,Ajah,by blenco supermarket sangotedo ajah lagos,1,2,1,1,1,1,1,1,1,1,5775000
24,Ajah,mrs ajah lagos,1,8,4,4,4,0,0,0,1,5,12600000
25,Ajah,"  salvation estate, off addo/langbasa road, ajah lagos",1,4,3,1,3,1,1,0,1,4,10500000
26,Ajah,royal gardens ajiwe ajah lagos,1,11,6,5,6,1,1,0,1,9,42000000
27,Ajah,badore ajah lagos,1,8,4,4,4,0,0,0,1,5,12600000
28,Ajah,- badore ajah lagos,1,2,1,1,1,0,0,0,1,1,4200000
29,Ajah,"  royal garden estate, ajiwe ajah lagos",1,11,6,5,6,1,1,1,1,9,52500000
30,Ajah,ado ajah lagos,1,9,5,4,5,1,1,0,1,8,31500000
31,Ajah,ado ajah lagos,1,10,6,4,6,1,1,0,1,9,42000000
32,Ajah,awoyaya ajah lagos,1,2,1,1,1,0,0,0,1,1,4200000
33,Ajah,infinity estate ado ajah lagos,1,8,4,4,4,0,0,0,1,5,12600000
34,Ajah,"  mobil estate, ilaje off northwest filling station ilaje ajah lagos",1,9,5,4,5,1,1,0,1,8,31500000
35,Ajah,- thomas estate ajah lagos,1,6,3,3,3,1,1,1,1,4,15750000
36,Ajah,cooperative estate badore ajah lagos,1,7,4,3,4,0,0,0,1,5,12600000
37,Ajah,mrs ajah lagos,1,4,2,2,2,1,1,0,1,4,8400000
38,Ajah,mobile road ilaje ajah lagos,1,5,3,2,3,1,1,1,1,4,12600000
39,Ajah,silver point estate badore ajah lagos,1,5,3,2,3,1,1,1,1,4,24150000
40,Ajah,abijo ajah lagos,1,2,1,1,1,0,0,0,1,1,4200000
41,Ajah,alpha bus stop sangotedo ajah lagos,1,3,2,1,2,1,1,0,1,4,8400000
42,Ajah,inside estate ado ajah lagos,1,6,3,3,3,0,0,0,1,4,9450000
43,Ajah,inside estate badore ajah lagos,1,2,1,1,1,0,0,0,1,1,4200000
44,Ajah,ado ajah lagos,1,4,2,2,2,1,1,0,1,4,8400000
45,Ajah,badore ajah lagos,1,9,5,4,5,1,1,0,1,8,31500000
46,Ajah,shoprite monastery road sangotedo ajah lagos,1,9,5,4,5,1,1,0,1,8,31500000
47,Ajah,good news estate sangotedo ajah lagos,1,7,4,3,4,1,0,0,1,5,13650000
48,Ajah,diamond estate sangotedo ajah lagos,1,9,5,4,5,1,1,0,1,8,31500000
49,Ajah,oke ira kekere ajah lagos,1,7,4,3,4,0,0,0,1,5,12600000
50,Ajah,harmony estate ado ajah lagos,1,7,4,3,4,0,0,0,1,5,12600000
53,Ajah,abraham adesanya estate ajah lagos,1,6,3,3,3,1,1,0,1,4,10500000
54,Ajah,marshy hill estate akins ado ajah lagos,1,2,1,1,1,1,1,1,1,1,5775000
55,Ajah,general paint alasia ajah ajah lagos,1,9,5,4,5,1,1,0,1,8,31500000
56,Ajah,thomas estate ajah thomas estate ajah lagos,1,5,3,2,3,0,0,0,1,4,9450000
57,Ajah,marina estate behind unity estate badore ajah badore ajah lagos,1,3,2,1,2,1,1,0,1,4,8400000
58,Ajah,marshy hill estate ado ajah lagos,1,2,1,1,1,0,0,0,1,1,4200000
59,Ajah,jubril estate olokonla just by lagos business school ajah olokonla ajah lagos,1,7,4,3,4,0,0,0,1,5,12600000
60,Ajah,good news estate sangotedo ajah lagos,1,7,4,3,4,0,0,0,1,5,12600000
61,Ajah,- abraham adesanya estate ajah lagos,1,2,1,1,1,1,0,0,1,1,4725000
62,Ajah,ilaje opposite vgc ilaje ajah lagos,1,7,4,3,4,1,1,1,1,5,16800000
63,Ajah,good news estate sangotedo sangotedo ajah lagos,1,7,4,3,4,0,0,0,1,5,12600000
64,Ajah,in an estate. badore ajah lagos,1,5,3,2,3,0,0,0,1,4,9450000
65,Ajah,marshy hill estate ado ajah lagos,1,7,4,3,4,0,0,0,1,5,12600000
66,Ajah,by abraham adesanya estate lekki gardens estate ajah lagos,1,7,4,3,4,1,1,1,1,5,16800000
67,Ajah,... abraham adesanya estate ajah lagos,1,4,2,2,2,1,1,1,1,4,9450000
68,Ajah,peaceville estate badore ajah lagos,1,9,5,4,5,1,1,0,1,8,31500000
69,Ajah," harmony estate, langbasa ajah lagos",1,7,4,3,4,0,0,0,1,5,12600000
70,Ajah," harmony estate, langbasa. ajah lagos",1,5,3,2,3,0,0,0,1,4,9450000
71,Ajah,crown estate sangotedo sangotedo ajah lagos,1,13,7,6,7,1,1,0,1,9,52500000
72,Ajah,back of blenco supermarket sangotedo ajah lagos,1,5,3,2,3,1,1,1,1,4,12600000
73,Ajah,rockstone estate after cooperative villa estate badore badore ajah lagos,1,5,3,2,3,0,0,0,1,4,9450000
74,Ajah,cooperative villa badore badore ajah lagos,1,5,3,2,3,0,0,0,1,4,9450000
75,Ajah,ajah lagos,1,7,4,3,4,0,0,0,1,5,12600000
76,Ajah,badore ajah lagos,1,7,4,3,4,0,0,0,1,5,12600000
77,Ajah,co-operation villa badore ajah lagos,1,5,3,2,3,0,0,0,1,4,9450000
78,Ajah,rockville estate badore ajah lagos,1,7,4,3,4,0,0,0,1,5,12600000
79,Ajah,rockville estate badore ajah lagos,1,7,4,3,4,0,0,0,1,5,12600000
80,Ajah,unity estate ado ajah lagos,1,7,4,3,4,0,0,0,1,5,12600000
81,Ajah,virgo estate badore ajah lagos,1,7,4,3,4,0,0,0,1,5,12600000
82,Ajah,pennisula estate sangotedo ajah lagos,1,7,4,3,4,0,0,0,1,5,12600000
83,Ajah,goodnews estate sangotedo ajah lagos,1,7,4,3,4,1,0,0,1,5,13650000
84,Ajah,greenville estate badore ajah lagos,1,7,4,3,4,0,0,0,1,5,12600000
85,Ajah,even estate ado ajah lagos,1,5,3,2,3,0,0,0,1,4,9450000
86,Ajah,royal palm estate badore ajah lagos,1,2,1,1,1,1,1,1,1,1,5250000
87,Ajah,ajah lagos,1,9,5,4,5,1,1,0,1,8,31500000
88,Ajah,greenville estate badore ajah lagos,1,9,5,4,5,1,1,0,1,8,31500000
89,Ajah,badore ajah lagos,1,8,4,4,4,0,0,0,1,5,12600000
90,Ajah,badore ajah lagos,1,6,3,3,3,0,0,0,1,4,9450000
91,Ajah,ado ajah lagos,1,5,3,2,3,0,0,0,1,4,9975000
92,Ajah,"lekki garden phase 2,opposite abraham adesanya abraham adesanya estate ajah lagos",1,7,4,3,4,1,1,1,1,5,15750000
93,Ajah,badore ajah lagos,1,6,3,3,3,0,0,0,1,4,9450000
94,Ajah,... badore ajah lagos,1,6,3,3,3,0,0,0,1,4,9450000
95,Ajah,silverpoint estate badore ajah lagos,1,5,3,2,3,0,0,0,1,4,9450000
96,Ajah,hitech estate sangotedo ajah lagos,1,7,4,3,4,1,0,0,1,5,13650000
97,Ajah,ado ajah lagos,1,9,5,4,5,1,1,0,1,8,31500000
98,Ajah,mobile ajah lagos,1,9,5,4,5,1,1,0,1,8,31500000
99,Ajah,green vill estate badore ajah lagos,1,6,3,3,3,0,0,0,1,4,9450000
100,Ajah,sangotedo ajah lagos,1,2,1,1,1,0,0,0,1,1,4200000
101,Ajah,badore ajah lagos,1,4,2,2,2,1,1,0,1,4,8400000
102,Ajah,badore ajah lagos,1,2,1,1,1,0,0,0,1,1,4200000
103,Ajah,- sangotedo ajah lagos,1,7,4,3,4,1,1,1,1,5,15750000
104,Ajah,badore ajah lagos,1,6,3,3,3,1,1,1,1,4,11550000
105,Ajah,greenville badore ajah lagos,1,3,2,1,2,1,1,0,1,4,8400000
106,Ajah,ogombo ajah lagos,1,2,1,1,1,1,1,1,1,1,5775000
107,Ajah," off mobil road, ilaje ajah lagos",1,7,4,3,4,0,0,0,1,5,12600000
108,Ajah,badore ajah lagos,1,2,1,1,1,0,0,0,1,1,4200000
109,Ajah,awoyaya ajah lagos,1,9,5,4,5,1,1,0,1,8,31500000
110,Ajah," fatai kaffo street,happy land estate olokonla ajah lagos",1,7,4,3,4,0,0,0,1,5,12600000
111,Ajah,mobil estate (emerald estate) ilaje ajah lagos,1,9,5,4,5,1,1,0,1,8,31500000
112,Ajah,- sangotedo ajah lagos,1,6,3,3,3,1,1,1,1,4,12600000
113,Ajah,badore ajah lagos,1,6,3,3,3,0,0,0,1,4,9450000
114,Ajah,badore ajah lagos,1,6,3,3,3,0,0,0,1,4,9450000
115,Ajah,badore ajah lagos,1,6,3,3,3,0,0,0,1,4,9450000
116,Ajah," lucky osujie, lekki palm city estate ado ajah lagos",1,9,5,4,5,1,1,0,1,8,31500000
117,Ajah,- ado ajah lagos,1,6,3,3,3,0,0,0,1,4,9450000
118,Ajah,badore ajah lagos,1,4,2,2,2,1,1,0,1,4,8400000
119,Ajah,emerald estate off mobil road ilaje ajah lagos,1,11,6,5,6,1,1,0,1,9,42000000
120,Ajah,badore ajah lagos,1,6,3,3,3,0,0,0,1,4,9450000
121,Ajah,ado ajah lagos,1,2,1,1,1,0,0,0,1,1,4200000
122,Ajah,awoyaya ajah lagos,1,8,4,4,4,0,0,0,1,5,12600000
123,Ajah,awoyaya ajah lagos,1,4,2,2,2,1,1,0,1,4,8400000
124,Ajah," salvation estate off addo/langbasa road, ajah lagos",1,3,2,1,2,1,1,0,1,4,8400000
125,Ajah,... badore ajah lagos,1,2,1,1,1,0,0,0,1,1,4200000
126,Ajah,badore ajah lagos,1,5,3,2,3,0,0,0,1,4,9450000
127,Ajah,badore ajah lagos,1,6,3,3,3,0,0,0,1,4,9450000
128,Ajah,alasela ogombo ajah lagos,1,4,2,2,2,1,1,0,1,4,8400000
129,Ajah,ado ajah lagos,1,5,3,2,3,1,1,0,1,4,10500000
130,Ajah,ado ajah lagos,1,4,2,2,2,1,1,0,1,4,8400000
131,Ajah,badore ajah lagos,1,3,2,1,2,1,1,0,1,4,8400000
132,Ajah,badore ajah lagos,1,4,2,2,2,1,1,0,1,4,8400000
133,Ajah,badore ajah lagos,1,2,1,1,1,0,0,0,1,1,4200000
134,Ajah,badore ajah lagos,1,6,3,3,3,0,0,0,1,4,9450000
135,Ajah,greenville estate badore ajah lagos,1,7,4,3,4,0,0,0,1,5,12600000
136,Ajah,badore ajah lagos,1,6,3,3,3,0,0,0,1,4,9450000
137,Ajah,badore ajah lagos,1,6,3,3,3,0,0,0,1,4,9450000
138,Ajah,badore ajah lagos,1,4,2,2,2,1,1,0,1,4,8400000
139,Ajah,... badore ajah lagos,1,9,5,4,5,1,1,0,1,8,31500000
140,Ajah,greenville estate badore ajah lagos,1,5,3,2,3,0,0,0,1,4,9450000
141,Ajah,mobile ajah lagos,1,9,5,4,5,1,1,0,1,8,31500000
142,Ajah,ado ajah lagos,1,9,5,4,5,1,1,0,1,8,31500000
143,Ajah,lekki scheme 2 ajah lagos,1,9,5,4,5,1,1,0,1,8,31500000
144,Ajah,lekki scheme 2 ajah lagos,1,9,5,4,5,1,1,0,1,8,31500000
145,Ajah,lekki scheme 2 ajah lagos,1,7,4,3,4,1,1,1,1,5,15750000
146,Ajah,- badore ajah lagos,1,4,2,2,2,1,1,0,1,4,8400000
147,Ajah,badore ajah lagos,1,6,3,3,3,0,0,0,1,4,9450000
148,Ajah,ado ajah lagos,1,4,2,2,2,1,1,0,1,4,8400000
149,Ajah,- badore ajah lagos,1,2,1,1,1,0,0,0,1,1,4200000
150,Ajah,ado ajah lagos,1,4,2,2,2,1,1,0,1,4,8400000
151,Ajah,badore ajah lagos,1,2,1,1,1,0,0,0,1,1,4200000
152,Ajah,lamgbasa ado ajah lagos,1,5,3,2,3,1,1,0,1,4,10500000
153,Ajah,abraham adesanya estate ajah lagos,1,6,3,3,3,1,1,1,1,4,15750000
154,Ajah,alaguntan ajah lagos,1,7,4,3,4,1,1,1,1,5,21000000
155,Ajah,ajah lagos,1,9,5,4,5,1,1,0,1,8,31500000
156,Ajah,.. sangotedo ajah lagos,1,7,4,3,4,0,0,0,1,5,12600000
157,Ajah,badore ajah lagos,1,2,1,1,1,0,0,0,1,1,4200000
158,Ajah,badore ajah lagos,1,6,3,3,3,0,0,0,1,4,9450000
159,Ajah,... badore ajah lagos,1,8,4,4,4,0,0,0,1,5,12600000
160,Ajah,by lekki gardens phase 2 abraham adesanya estate ajah lagos,1,7,4,3,4,1,1,1,1,5,21000000
161,Ajah,ado ajah lagos,1,11,6,5,6,1,1,0,1,9,42000000
162,Ajah,badore ajah lagos,1,6,3,3,3,0,0,0,1,4,9450000
163,Ajah,badore ajah lagos,1,4,2,2,2,1,1,0,1,4,8400000
164,Ajah,gold in estate badore ajah lagos,1,6,3,3,3,0,0,0,1,4,9450000
165,Ajah,badore ajah lagos,1,6,3,3,3,0,0,0,1,4,9450000
166,Ajah,thomas estate ajah lagos,1,6,3,3,3,1,1,0,1,4,10500000
167,Ajah," idowu estate, oke ira ado ajah lagos",1,5,3,2,3,0,0,0,1,4,9450000
168,Ajah,- sangotedo ajah lagos,1,5,3,2,3,1,1,1,1,4,13650000
169,Ajah,lbs ajah lagos,1,7,4,3,4,0,0,0,1,5,12600000
170,Ajah,badore ajah lagos,1,6,3,3,3,0,0,0,1,4,9450000
171,Ajah,badore ajah lagos,1,2,1,1,1,0,0,0,1,1,4200000
172,Ajah,facing locuse army on ado road ado ajah lagos,1,6,3,3,3,0,0,0,1,4,9450000
173,Ajah,abraham adesanya estate ajah lagos,1,7,4,3,4,1,1,1,1,5,15750000
174,Ajah,.. abraham adesanya estate ajah lagos,1,7,4,3,4,1,1,1,1,5,15750000
175,Ajah,- sangotedo ajah lagos,1,5,3,2,3,1,1,1,1,4,13650000
176,Ajah,- sangotedo ajah lagos,1,7,4,3,4,0,0,0,1,5,12600000
177,Ajah,sangotedo ajah lagos,1,9,5,4,5,1,1,0,1,8,31500000
178,Ajah,sangotedo ajah lagos,1,9,5,4,5,1,1,1,1,8,52500000
179,Ajah,sangotedo ajah lagos,1,15,8,7,8,1,1,0,1,10,57750000
180,Ajah,badore ajah lagos,1,4,2,2,2,1,1,0,1,4,8400000
181,Ajah,badore ajah lagos,1,8,4,4,4,1,1,1,1,5,15750000
182,Ajah,badore ajah lagos,1,8,4,4,4,0,0,0,1,5,12600000
183,Ajah,lbs sangotedo ajah lagos,1,15,8,7,8,1,1,0,1,10,57750000
184,Ajah," mobil road, ilaje ajah lagos",1,9,5,4,5,1,1,0,1,8,31500000
185,Ajah," opposite eco bank, pavilion estate ado road ajah ado ajah lagos",1,9,5,4,5,1,1,0,1,8,31500000
186,Ajah,badore ajah lagos,1,8,4,4,4,0,0,0,1,5,12600000
187,Ajah,badore ajah lagos,1,6,3,3,3,0,0,0,1,4,9450000
188,Ajah,badore ajah lagos,1,6,3,3,3,0,0,0,1,4,9450000
189,Ajah,... badore ajah lagos,1,6,3,3,3,0,0,0,1,4,9450000
190,Ajah,badore ajah lagos,1,5,3,2,3,0,0,0,1,4,9450000
191,Ajah,thomas estate thomas estate ajah lagos,1,7,4,3,4,1,1,1,1,5,21000000
192,Ajah,sangotedo ajah lagos,1,5,3,2,3,1,1,1,1,4,12600000
193,Ajah,... thomas estate ajah lagos,1,4,2,2,2,1,1,0,1,4,8400000
194,Ajah,badore ajah lagos,1,2,1,1,1,0,0,0,1,1,4200000
195,Ajah,badore ajah lagos,1,2,1,1,1,0,0,0,1,1,4200000
196,Ajah,kajola after lakwe lakowe ajah lagos,1,2,1,1,1,0,0,0,1,1,4200000
197,Ajah,gbetu road awoyaya off lekki epe expressway ajah lagos,1,12,6,6,6,1,1,0,1,9,42000000
198,Ajah,west wood street. badore ajah lagos,1,2,1,1,1,0,0,0,1,1,4200000
199,Ajah,badore ajah lagos,1,3,2,1,2,1,1,0,1,4,8400000
200,Ajah,ado ajah lagos,1,5,3,2,3,0,0,0,1,4,9450000
201,Ajah,mobil road ilaje ajah lagos,1,9,5,4,5,1,1,0,1,8,31500000
202,Ajah," harmony estate, ajah badagry badagry lagos",1,4,2,2,2,1,1,0,1,4,8400000
203,Ajah,victory park thomas estate ajah lagos,1,11,6,5,6,1,1,0,1,9,42000000
204,Ajah,by lagos business school olokonla ajah lagos,1,3,2,1,2,1,1,0,1,4,8400000
205,Ajah,alaguntan ilaje ajah lagos,1,11,6,5,6,1,1,0,1,9,42000000
206,Ajah,safecourt estate badore ajah lagos,1,7,4,3,4,1,1,1,1,5,31500000
207,Ajah,lekki scheme 2 ogombo ajah lagos,1,9,5,4,5,1,1,0,1,8,31500000
208,Ajah,badore ajah lagos,1,9,5,4,5,1,1,0,1,8,31500000
209,Ajah,.. thomas estate ajah lagos,1,5,3,2,3,1,1,0,1,4,10500000
210,Ajah,peninsula garden estate sangotedo ajah lagos,1,9,5,4,5,1,1,0,1,8,31500000
211,Ajah,lagos business school olokonla ajah lagos,1,5,3,2,3,1,1,1,1,4,12600000
212,Ajah,golden pearls estate sangotedo ajah lagos,1,11,6,5,6,1,1,0,1,9,42000000
213,Ajah,mobil estate ilaje ajah lagos,1,9,5,4,5,1,1,0,1,8,31500000
214,Ajah,alhaji folami street off mobil road illaje ajah ilaje ajah lagos,1,7,4,3,4,0,0,0,1,5,12600000
215,Ajah," unity avenue estate, pump and sell addo road ajah ado ajah lagos",1,6,3,3,3,1,1,1,1,4,12600000
216,Ajah,off mobil road illaje ajah ilaje ajah lagos,1,5,3,2,3,1,1,0,1,4,10500000
217,Ajah,orile maroko estate opposite emerald estate mobil road illaje ajah ilaje ajah lagos,1,8,3,5,3,1,1,0,1,4,10500000
218,Ajah,ado ajah lagos,1,5,3,2,3,0,0,0,1,4,9450000
219,Ajah,ado ajah lagos,1,5,3,2,3,0,0,0,1,4,9450000
220,Ajah,off mobile road ajiwe ajah lagos,1,4,2,2,2,1,1,1,1,4,10500000
221,Ajah,badore ajah lagos,1,9,4,5,4,0,0,0,1,5,12600000
222,Ajah,thomas estate ajah lagos,1,9,5,4,5,1,1,0,1,8,31500000
223,Ajah,thomas estate ajah lagos,1,9,5,4,5,1,1,0,1,8,31500000
224,Ajah,harmony estate lanbasa ado ajah lagos,1,8,4,4,4,0,0,0,1,5,12600000
225,Ajah,badore ajah lagos,1,9,5,4,5,1,1,0,1,8,31500000
226,Ajah,awoyaya awoyaya ajah lagos,1,9,5,4,5,1,1,0,1,8,31500000
227,Ajah,abraham adesanya estate ajah lagos,1,2,1,1,1,0,0,0,1,1,4200000
228,Ajah," langbasa, addo road. ajah. ado ajah lagos",1,6,3,3,3,0,0,0,1,4,9450000
229,Ajah," greenville estate badore, ajah badore ajah lagos",1,6,3,3,3,0,0,0,1,4,9450000
230,Ajah,ajah lagos,1,12,6,6,6,1,1,0,1,9,42000000
231,Ajah,ajah lagos,1,6,3,3,3,1,1,0,1,4,10500000
232,Ajah,ajah lagos,1,10,5,5,5,1,1,1,1,8,52500000
233,Ajah,ado ajah lagos,1,5,3,2,3,0,0,0,1,4,9975000
234,Ajah,mobil road immediately after emerald estate ilaje ajah lagos,1,7,4,3,4,0,0,0,1,5,12600000
235,Ajah,value county estate near lagos business school off lekki epe expressway ajah lagos,1,8,4,4,4,1,0,0,1,5,13650000
236,Ajah,after lbs in olokonla in ajah axis lekki. olokonla ajah lagos,1,7,4,3,4,0,0,0,1,5,12600000
237,Ajah,opp ikota villa before ajah in lekki. lekki phase 2 lekki lagos,1,4,2,2,2,1,1,0,1,4,8925000
238,Ajah,ado ajah lagos,1,7,4,3,4,0,0,0,1,5,12600000
239,Ajah,ado ajah lagos,1,7,4,3,4,0,0,0,1,5,12600000
240,Ajah,peace estate badore ajah lagos,1,3,2,1,2,1,1,0,1,4,8400000
241,Ajah,ajah lagos,1,2,1,1,1,0,0,0,1,1,4200000
242,Ajah,ado ajah lagos,1,4,2,2,2,1,1,1,1,4,9450000
243,Ajah,remlek estate badore ajah badore ajah lagos,1,4,2,2,2,1,1,0,1,4,8400000
244,Ajah,badore ajah lagos,1,3,2,1,2,1,1,0,1,4,8400000
245,Ajah,badore ajah lagos,1,3,2,1,2,1,1,0,1,4,8400000
246,Ajah,badore ajah lagos,1,3,2,1,2,1,1,0,1,4,8400000
247,Ajah," iyabus plaza pump and sell area, ado ajah lagos",1,6,3,3,3,0,0,0,1,4,9450000
248,Ajah,ado ajah lagos,1,4,2,2,2,1,1,0,1,4,8400000
249,Ajah,badore ajah lagos,1,4,2,2,2,1,1,0,1,4,8400000
250,Ajah,badore ajah lagos,1,2,1,1,1,0,0,0,1,1,4200000
251,Ajah,thomas estates thomas estate ajah lagos,1,3,2,1,2,1,1,0,1,4,8400000
252,Ajah,orile maroko estate opp emerald estate mobil road illaje ajah ilaje ajah lagos,1,6,3,3,3,0,0,0,1,4,9450000
253,Ajah,ajiwe ajah lagos,1,4,2,2,2,1,1,1,1,4,13650000
254,Ajah,badore ajah lagos,1,6,3,3,3,0,0,0,1,4,9450000
255,Ajah,around blenco supermarket before sangotedo. peninsula estate ajah lagos,1,7,4,3,4,1,1,1,1,5,21000000
256,Ajah,around blenco supermarket before sangotedo in ajah axis lekki. peninsula estate ajah lagos,1,3,2,1,2,1,1,0,1,4,8400000
257,Ajah,after blenco supermarket before sangotedo market in ajah axis lekki. sangotedo ajah lagos,1,7,4,3,4,0,0,0,1,5,12600000
258,Ajah,fidiso estate in kingdom hall road in abijo in ajah axis lekki. abijo ajah lagos,1,2,1,1,1,0,0,0,1,1,4200000
259,Ajah,after blenco supermarket before sangotedo market in ajah axis lekki. sangotedo ajah lagos,1,9,5,4,5,1,1,0,1,8,31500000
260,Ajah,majek sangotedo in ajah axis lekki. sangotedo ajah lagos,1,3,2,1,2,1,1,0,1,4,8400000
261,Ajah,opp sangotedo market in ajah axis lekki. sangotedo ajah lagos,1,5,3,2,3,0,0,0,1,4,9450000
262,Ajah,opp sangotedo market in ajah axis lekki. sangotedo ajah lagos,1,7,4,3,4,0,0,0,1,5,12600000
263,Ajah,abijo ajah lagos,1,2,1,1,1,1,0,0,1,1,4725000
264,Ajah,seaside estate badore ajah lagos,1,5,3,2,3,0,0,0,1,4,9450000
265,Ajah,ado and environs ado ajah lagos,1,6,3,3,3,0,0,0,1,4,9450000
266,Ajah,ado ajah lagos,1,6,3,3,3,0,0,0,1,4,9450000
267,Ajah,ado and environs ado ajah lagos,1,6,3,3,3,0,0,0,1,4,9450000
268,Ajah,abraham adesanya estate ajah lagos,1,10,5,5,5,1,1,0,1,8,31500000
269,Ajah,majek sangotedo ajah lagos,1,2,1,1,1,0,0,0,1,1,4200000
270,Ajah,thomas estate ajah lagos,1,5,2,3,2,1,1,0,1,4,8400000
271,Ajah,abraham adesanya estate ajah lagos,1,2,1,1,1,1,1,1,1,1,10500000
272,Ajah,abraham adesanya estate ajah lagos,1,4,2,2,2,1,1,0,1,4,8400000
273,Ajah,thomas estate ajah lagos,1,4,2,2,2,1,1,0,1,4,8400000
274,Ajah,thomas estate ajah lagos,1,3,2,1,2,1,1,0,1,4,8400000
275,Ajah,badore ajah lagos,1,5,3,2,3,0,0,0,1,4,9450000
276,Ajah,mobil road illaje ajah lagos state ilaje ajah lagos,1,9,5,4,5,1,1,1,1,8,52500000
277,Ajah,good news estate sangotedo ajah lagos,1,10,5,5,5,1,1,1,1,8,52500000
278,Ajah,lekki garden estate phase 4 lekki gardens estate ajah lagos,1,9,5,4,5,1,1,0,1,8,31500000
279,Ajah,ajiwe ajah lagos,1,9,5,4,5,1,1,0,1,8,31500000
280,Ajah,behind the new shoprite in sangotedo in ajah axis lekki. sangotedo ajah lagos,1,10,5,5,5,1,1,0,1,8,31500000
281,Ajah,pump and sell bustop addo road ajah ado ajah lagos,1,5,3,2,3,0,0,0,1,4,9450000
282,Ajah,lekki palm city estate off lekki epe expressway ajah lagos,1,7,4,3,4,1,1,1,1,5,17850000
283,Ajah,greenville estate badore ajah badore ajah lagos,1,2,1,1,1,1,1,1,1,1,5250000
284,Ajah,badore ajah lagos,1,4,2,2,2,1,1,1,1,4,10500000
285,Ajah,off addo road marshy hill estate ado ajah lagos,1,6,3,3,3,1,1,1,1,4,12600000
286,Ajah,bakery bustop opp rockstone estate badore road ajah badore ajah lagos,1,5,3,2,3,0,0,0,1,4,9450000
287,Ajah,before blenco supermarket in olokonla in ajah axis lekki. olokonla ajah lagos,1,10,5,5,5,1,1,0,1,8,31500000
288,Ajah,pump and sell addo road ajah ado ajah lagos,1,7,4,3,4,0,0,0,1,5,12600000
289,Ajah,off mobile road ajah lagos,1,4,2,2,2,1,1,1,1,4,10500000
290,Ajah,marshy hill estate akins bustop addo road ajah ado ajah lagos,1,2,1,1,1,0,0,0,1,1,4200000
291,Ajah,marshy hill estate ado ajah lagos,1,7,4,3,4,0,0,0,1,5,12600000
292,Ajah," ologunfe, awoyaya ajah lagos",1,7,4,3,4,0,0,0,1,5,12600000
293,Ajah,mobil road ilaje ajah lagos,1,8,4,4,4,1,1,1,1,5,15750000
294,Ajah,majek opp fara park after crown estate in sangotedo in ajah axis lekki. crown estate ajah lagos,1,8,4,4,4,0,0,0,1,5,12600000
295,Ajah,ogombo ajah lagos,1,9,5,4,5,1,1,0,1,8,31500000
296,Ajah,greenville estate badore ajah badore ajah lagos,1,5,3,2,3,0,0,0,1,4,9450000
297,Ajah,lekki palms estate lavalon hotel estate off addo road ajah ado ajah lagos,1,9,5,4,5,1,1,0,1,8,31500000
298,Ajah,esfort estate opp mfm ajah off addo road ajah ado ajah lagos,1,9,5,4,5,1,1,0,1,8,31500000
299,Ajah,marshy hill estate ado ajah lagos,1,7,4,3,4,1,0,0,1,5,13650000
300,Ajah,before fara park after crown estate in sangotedo in ajah axis. crown estate ajah lagos,1,11,6,5,6,1,1,0,1,9,42000000
301,Ajah," around crown estate, sangotedo, ajah axis, lekki. sangotedo ajah lagos",1,6,3,3,3,1,1,0,1,4,10500000
302,Ajah,greenville estate badore ajah badore ajah lagos,1,5,3,2,3,0,0,0,1,4,9450000
303,Ajah,within an estate sangotedo ajah lagos,1,7,4,3,4,0,0,0,1,5,12600000
304,Ajah," gated estate, addo road ado ajah lagos",1,5,3,2,3,1,1,0,1,4,10500000
305,Ajah," gated estate, addo road ado ajah lagos",1,5,3,2,3,1,1,0,1,4,10500000
306,Ajah,ajah ajah lagos,1,2,1,1,1,0,0,0,1,1,4200000
307,Ajah,greenville estate badore ajah lagos,1,4,2,2,2,1,1,0,1,4,8400000
308,Ajah,ado ado ajah lagos,1,5,3,2,3,0,0,0,1,4,9450000
309,Ajah,ajah lagos,1,6,3,3,3,1,1,0,1,4,10500000
310,Ajah,gated street by junction/harmony estate bustop langbasa road addo ajah ado ajah lagos,1,4,2,2,2,1,1,0,1,4,8400000
311,Ajah,before sangotedo market in sangotedo in ajah axis lekki. sangotedo ajah lagos,1,6,3,3,3,0,0,0,1,4,9450000
312,Ajah,ajah lagos,1,4,2,2,2,1,1,0,1,4,8400000
313,Ajah,chinese road junction bustop addo - langbasa rd ajah ado ajah lagos,1,5,3,2,3,0,0,0,1,4,9450000
314,Ajah,around the new shoprite in sangotedo in ajah axis lekki. sangotedo ajah lagos,1,10,5,5,5,1,1,0,1,8,31500000
315,Ajah,remlek estate badore ajah badore ajah lagos,1,2,1,1,1,1,1,1,1,1,5250000
316,Ajah,greenville estate badore ajah badore ajah lagos,1,2,1,1,1,0,0,0,1,1,4200000
317,Ajah,greenville estate badore ajah badore ajah lagos,1,2,1,1,1,1,1,1,1,1,5250000
318,Ajah,teran x estate near bleco super market olokonla ajah lagos,1,5,3,2,3,1,1,1,1,4,11550000
319,Ajah,elegant court estate mobil road illaje ajah ilaje ajah lagos,1,7,4,3,4,0,0,0,1,5,12600000
320,Ajah,royal palm will estate remlek badore ajah lagos,1,5,3,2,3,0,0,0,1,4,9450000
321,Ajah," majek, after crown estate in ajah axis lekki. crown estate ajah lagos",1,8,4,4,4,0,0,0,1,5,12600000
322,Ajah,peninsula estate ajah lagos,1,7,4,3,4,1,1,1,1,5,16800000
323,Ajah,anu crescent estate badore ajah lagos,1,4,2,2,2,1,1,1,1,4,10500000
324,Ajah,powerline estate opp sunny villa estate badore ajah badore ajah lagos,1,5,3,2,3,0,0,0,1,4,9450000
325,Ajah," onison street, lakowe lakowe ajah lagos",1,5,3,2,3,0,0,0,1,4,9450000
326,Ajah,anu crescent badore ajah lekki badore ajah lagos,1,4,2,2,2,1,1,1,1,4,10500000
327,Ajah,ajah lagos,1,4,2,2,2,1,1,0,1,4,8400000
328,Ajah,ogunfayo ibeju-lekki sangotedo ajah lagos,1,2,1,1,1,0,0,0,1,1,4200000
329,Ajah," cooperative villa road, badore badore ajah lagos",1,12,6,6,6,1,1,0,1,9,42000000
330,Ajah,red roof bustop langbasa road ajah ado ajah lagos,1,3,2,1,2,1,1,0,1,4,8400000
331,Ajah,majek opp fara park after crown estate in ajah axis lekki. crown estate ajah lagos,1,2,1,1,1,0,0,0,1,1,4200000
332,Ajah,greenville estate badore ajah badore ajah lagos,1,2,1,1,1,0,0,0,1,1,4200000
333,Ajah," mayfair garden, awoyaya, ajah axis lekki. awoyaya ajah lagos",1,8,4,4,4,1,1,1,1,5,15750000
334,Ajah,marshy hill estate akins bustop off addo road ajah ado ajah lagos,1,7,4,3,4,0,0,0,1,5,12600000
335,Ajah,an estate in abijo after crown estate in ajah axis lekki. abijo ajah lagos,1,6,3,3,3,0,0,0,1,4,9450000
336,Ajah,ajah ajah lagos,1,2,1,1,1,0,0,0,1,1,4200000
337,Ajah,ajah lagos,1,6,3,3,3,1,1,0,1,4,10500000
338,Ajah,badore ajah lagos,1,6,3,3,3,0,0,0,1,4,9450000
339,Ajah," within an estate, off ado road. ado ajah lagos",1,7,4,3,4,0,0,0,1,5,12600000
340,Ajah,gated street by junction bustop opp harmony estate langbasa road ajah ado ajah lagos,1,5,3,2,3,0,0,0,1,4,9450000
341,Ajah," blenco supermarket before sangotedo, after lbs. peninsula estate ajah lagos",1,9,5,4,5,1,1,0,1,8,31500000
342,Ajah,meridian luxury park estate awoyaya ajah lagos,1,7,4,3,4,0,0,0,1,5,12600000
343,Ajah,.. sangotedo ajah lagos,1,6,3,3,3,1,1,1,1,4,14700000
344,Ajah," majek after fara park, after crown estate in ajah axis lekki. crown estate ajah lagos",1,8,4,4,4,0,0,0,1,5,12600000
345,Ajah," behind abraham adesanya round about, ajah lagos",1,11,6,5,6,1,1,0,1,9,42000000
346,Ajah,lagum view estate opp catholic church ajah lagos,1,12,6,6,6,1,1,0,1,9,42000000
347,Ajah,before blenco supermarket before sangotedo in ajah axis lekki. olokonla ajah lagos,1,6,3,3,3,0,0,0,1,4,9450000
348,Ajah,emerald housing estate ilaje ajah lagos,1,8,4,4,4,1,1,1,1,5,26250000
349,Ajah,general paint bus stop just by abraham adesanya estate abraham adesanya estate ajah lagos,1,9,5,4,5,1,1,0,1,8,31500000
350,Ajah,sangotedo sangotedo ajah lagos,1,7,4,3,4,1,0,0,1,5,13650000
351,Ajah,lekki scheme 2 ajiwe ajah lagos,1,10,5,5,5,1,1,0,1,8,31500000
352,Ajah,after lbs in olokonla in ajah axis lekki. olokonla ajah lagos,1,6,3,3,3,0,0,0,1,4,9450000
353,Ajah,olokonla olokonla ajah lagos,1,7,4,3,4,0,0,0,1,5,12600000
354,Ajah,loshoro..school gate badore ajah lagos,1,2,1,1,1,0,0,0,1,1,4200000
355,Ajah,reservation estate langbasa road owode addo ajah ado ajah lagos,1,5,3,2,3,1,1,0,1,4,10500000
356,Ajah,off mobil road ilaje ajah lagos,1,4,2,2,2,1,1,1,1,4,10500000
357,Ajah,sangotedo ajah lagos,1,4,2,2,2,1,1,0,1,4,8400000
358,Ajah,awoyaya bus stop awoyaya ajah lagos,1,7,4,3,4,0,0,0,1,5,12600000
359,Ajah,sangotedo ajah lagos,1,6,3,3,3,0,0,0,1,4,9450000
360,Ajah,red roof bustop addo - langbasa rd ajah ado ajah lagos,1,3,2,1,2,1,1,0,1,4,8400000
361,Ajah,greenville estate badore ajah badore ajah lagos,1,2,1,1,1,1,1,1,1,1,5250000
362,Ajah,crown estate crown estate ajah lagos,1,8,4,4,4,1,1,1,1,5,31500000
363,Ajah,esfort estate addo road ajah ado ajah lagos,1,2,1,1,1,1,1,1,1,1,7350000
364,Ajah,estate after crown estate in ajah axis lekki. abijo ajah lagos,1,6,3,3,3,0,0,0,1,4,9450000
365,Ajah," abraham adesanya estate, ajah lagos",1,2,1,1,1,0,0,0,1,1,4200000
366,Ajah,marshy hill estate ado ajah lagos,1,7,4,3,4,0,0,0,1,5,12600000
367,Ajah,chevron alternative ajah lagos,1,9,5,4,5,1,1,1,1,8,36750000
368,Ajah,gated estate opp emerald estate mobil road illaje ajah ilaje ajah lagos,1,5,3,2,3,0,0,0,1,4,9450000
369,Ajah," destiny homes estate in abijo, after fara park, after crown estate in ajah axis lekki. crown estate ajah lagos",1,8,4,4,4,0,0,0,1,5,12600000
370,Ajah,ajose street badore ajah badore ajah lagos,1,7,4,3,4,0,0,0,1,5,13125000
371,Ajah,gated street by junction bustop harmony estate langbasa rd ajah ado ajah lagos,1,3,2,1,2,1,1,0,1,4,8400000
372,Ajah,ajah lagos,1,6,3,3,3,1,1,1,1,4,15750000
373,Ajah,gated estate by junction bustop facing harmony estate langbasa road ajah ado ajah lagos,1,5,3,2,3,0,0,0,1,4,9450000
374,Ajah,remlek estate badore ajah badore ajah lagos,1,7,4,3,4,0,0,0,1,5,12600000
375,Ajah,omoba bade street marshy hill estate ado ajah lagos,1,7,4,3,4,0,0,0,1,5,12600000
376,Ajah,ocean palm estate sangotedo ajah lagos,1,5,3,2,3,1,1,1,1,4,11550000
377,Ajah,unity estate maryland badore ajah badore ajah lagos,1,9,5,4,5,1,1,0,1,8,31500000
378,Ajah,pearl garden estate sangotedo ajah lagos,1,9,5,4,5,1,1,0,1,8,31500000
379,Ajah,greenville estate badore ajah badore ajah lagos,1,5,3,2,3,0,0,0,1,4,9450000
380,Ajah,marshy hill estate addo road ajah ado ajah lagos,1,2,1,1,1,1,0,0,1,1,4725000
381,Ajah,before the new shoprite in sangotedo in ajah axis lekki. sangotedo ajah lagos,1,8,4,4,4,0,0,0,1,5,12600000
382,Ajah,golf road lakowe lakowe ajah lagos,1,8,4,4,4,1,1,1,1,5,31500000
383,Ajah," crown estate, sangotedo, ajah axis lekki. crown estate ajah lagos",1,8,4,4,4,1,1,1,1,5,15750000
384,Ajah,green ville estate badore ajah lagos,1,2,1,1,1,1,1,1,1,1,5250000
385,Ajah,thomas estate thomas estate ajah lagos,1,6,3,3,3,1,1,1,1,4,16800000
386,Ajah," infinity estate, ado road. ado ajah lagos",1,5,3,2,3,1,1,1,1,4,15750000
387,Ajah,seaside estate badore ajah lagos,1,5,3,2,3,0,0,0,1,4,9450000
388,Ajah,by hot bread sangotedo ajah lagos,1,2,1,1,1,0,0,0,1,1,4200000
389,Ajah," united estate, sangotedo ajah lagos",1,7,4,3,4,0,0,0,1,5,12600000
390,Ajah,divine homes estate thomas estate ajah lagos,1,9,5,4,5,1,1,0,1,8,31500000
391,Ajah,an estate in abijo after crown estate in ajah axis lekki. abijo ajah lagos,1,6,3,3,3,0,0,0,1,4,9450000
392,Ajah,peace estate cocacola bustop badore ajah badore ajah lagos,1,3,2,1,2,1,1,0,1,4,8400000
393,Ajah,apteck rd sangotedo ajah lagos,1,7,4,3,4,0,0,0,1,5,12600000
394,Ajah,within a very secure and peaceful estate ado ajah lagos,1,7,4,3,4,0,0,0,1,5,12600000
395,Ajah,behind the new shoprite in sangotedo in ajah axis lekki. sangotedo ajah lagos,1,10,5,5,5,1,1,0,1,8,31500000
396,Ajah,lavalon hotel road opp eco bank addo road ajah ado ajah lagos,1,5,3,2,3,1,1,0,1,4,10500000
397,Ajah,abijo ajah lagos,1,11,6,5,6,1,1,1,1,9,52500000
398,Ajah,unity estate maryland badore ajah badore ajah lagos,1,2,1,1,1,0,0,0,1,1,4200000
399,Ajah," around blenco supermarket before sangotedo, ajah axis lekki. sangotedo ajah lagos",1,10,5,5,5,1,1,0,1,8,31500000
400,Ajah,illaje off emerald estate mobil road illaje ajah ilaje ajah lagos,1,7,4,3,4,1,1,1,1,5,15750000
401,Ajah,ajah lagos,1,6,3,3,3,1,1,1,1,4,17850000
402,Ajah,marshy hill estate akins bustop addo road ajah ado ajah lagos,1,5,3,2,3,0,0,0,1,4,9975000
403,Ajah,lekki palm city estate ado ajah lagos,1,8,4,4,4,1,1,1,1,5,24150000
404,Ajah," united estate, sangotedo, ajah axis, lekki. sangotedo ajah lagos",1,6,3,3,3,0,0,0,1,4,9450000
405,Ajah,harmony estate langbasa rd ajah ado ajah lagos,1,9,5,4,5,1,1,0,1,8,31500000
406,Ajah,berulah estate by addo round about addo ajah ado ajah lagos,1,5,3,2,3,0,0,0,1,4,9450000
407,Ajah,seaside estate ajah lagos,1,6,3,3,3,1,1,0,1,4,10500000
408,Ajah,silverpoint estate badore ajah lagos,1,5,3,2,3,0,0,0,1,4,9450000
409,Ajah," lekki palm city estate, off ado road, ajah, lagos. badore ajah lagos",1,9,5,4,5,1,1,0,1,8,31500000
410,Ajah," otunla street, lakowe lakowe ajah lagos",1,5,3,2,3,0,0,0,1,4,9450000
411,Ajah,lavalon hotel estate opp eco bank addo road ajah ado ajah lagos,1,7,4,3,4,1,0,0,1,5,13650000
412,Ajah,ajah lagos,1,6,3,3,3,1,1,1,1,4,24150000
413,Ajah,before blenco supermarket in olokonla in ajah axis lekki. olokonla ajah lagos,1,6,3,3,3,0,0,0,1,4,9450000
414,Ajah,harmony estate langbasa rd ajah ado ajah lagos,1,5,3,2,3,0,0,0,1,4,9450000
415,Ajah,mega estate black gate bustop badore ajah badore ajah lagos,1,7,4,3,4,1,0,0,1,5,13650000
416,Ajah,royal garden estate ajah lagos,1,10,5,5,5,1,1,1,1,8,42000000
417,Ajah,general paint bus stop sangotedo ajah lagos,1,11,5,6,5,1,1,0,1,8,31500000
418,Ajah,beside lagos business school ajah lagos,1,7,4,3,4,1,0,0,1,5,13650000
419,Ajah,gated mobile road opposite llaje bf ajah bridge ilaje ajah lagos,1,4,2,2,2,1,1,1,1,4,12600000
420,Ajah," majek after fara park, after crown estate in ajah axis lekki. crown estate ajah lagos",1,6,3,3,3,0,0,0,1,4,9450000
421,Ajah," majek, opposite fara park, in ajah axis lekki. crown estate ajah lagos",1,4,2,2,2,1,1,0,1,4,8400000
422,Ajah," united estate, sangotedo, ajah axis, lekki. sangotedo ajah lagos",1,4,2,2,2,1,1,0,1,4,8400000
423,Ajah,ajah lagos,1,6,3,3,3,1,1,1,1,4,16800000
424,Ajah,lekki scheme 2 abraham adesanya ogombo road ajah ogombo ajah lagos,1,5,3,2,3,1,1,0,1,4,10500000
425,Ajah,westwood estate badore ajah lagos,1,2,1,1,1,1,1,1,1,1,6300000
426,Ajah,lekki scheme 2 abraham adesanya ogombo road ajah ilaje ajah lagos,1,7,4,3,4,1,1,1,1,5,15750000
427,Ajah,unity estate maryland badore ajah badore ajah lagos,1,7,4,3,4,0,0,0,1,5,12600000
428,Ajah,thera annex sangotedo ajah lagos,1,5,3,2,3,0,0,0,1,4,9450000
429,Ajah,blenco sangotedo ajah lagos,1,7,4,3,4,0,0,0,1,5,12600000
430,Ajah," salvation estate, owode, ajah ado ajah lagos",1,4,2,2,2,1,1,0,1,4,8400000
431,Ajah,salvation estate scheme 2 ado ajah lagos,1,7,4,3,4,0,0,0,1,5,12600000
432,Ajah," lekki palm city estate, opposite ecobank ado road ajah lagos ado ajah lagos",1,5,3,2,3,1,1,1,1,4,14700000
433,Ajah,cooperative villa badore ajah badore ajah lagos,1,5,3,2,3,0,0,0,1,4,9450000
434,Ajah,new road awoyaya ajah lagos,1,4,2,2,2,1,1,0,1,4,8400000
435,Ajah,new road awoyaya ajah lagos,1,6,3,3,3,0,0,0,1,4,9450000
436,Ajah,divine estate okun ajah okun ajah ajah lagos,1,4,2,2,2,1,1,0,1,4,8925000
437,Ajah,greenville estate badore ajah lagos,1,4,2,2,2,1,1,0,1,4,8400000
438,Ajah," madam theresa avenue, maryland estate badore ajah lagos",1,6,3,3,3,0,0,0,1,4,9450000
439,Ajah," ogunfayo,awoyaya (immediately after mayfair garden estate, awoyaya) awoyaya ajah lagos",1,4,2,2,2,1,1,0,1,4,8400000
440,Ajah," ogunfayo,awoyaya (immediately after mayfair garden estate, awoyaya) awoyaya ajah lagos",1,2,1,1,1,0,0,0,1,1,4200000
441,Ajah,abraham adesanya estate ajah lagos,1,2,1,1,1,1,0,0,1,1,4725000
442,Ajah,sangotedo ajah lagos,1,2,1,1,1,1,1,1,1,1,5250000
443,Ajah," awoyaya, ajah lagos",1,2,1,1,1,0,0,0,1,1,4200000
444,Ajah,ogadan ajah lagos,1,5,3,2,3,1,1,0,1,4,10500000
445,Ajah," majek town, sangotedo ajah lagos",1,5,3,2,3,0,0,0,1,4,9450000
446,Ajah,alashela ogombo ajah lagos,1,5,3,2,3,0,0,0,1,4,9450000
447,Ajah,liberty bells schools badore ajah lagos,1,7,4,3,4,0,0,0,1,5,12600000
448,Ajah," by total filling station, abraham adesanya ajiwe ajah lagos",1,10,5,5,5,1,1,0,1,8,31500000
449,Ajah,adeba road lakowe ajah lagos,1,3,2,1,2,1,1,0,1,4,8400000
450,Ajah,liberty bells school badore ajah lagos,1,7,4,3,4,0,0,0,1,5,12600000
451,Ajah,cooperative estate badore ajah lagos,1,8,4,4,4,0,0,0,1,5,12600000
452,Ajah,"15 isah omale street, glorious estate badore ajah lagos",1,5,3,2,3,0,0,0,1,4,9450000
453,Ajah,adenike olotu street ilaje ajah lagos,1,10,5,5,5,1,1,0,1,8,31500000
454,Ajah,greenville estate badore addo road ajah lagos badore ajah lagos,1,5,3,2,3,0,0,0,1,4,9450000
455,Ajah," silverland estate, sangotedo ajah lagos",1,2,1,1,1,0,0,0,1,1,4200000
456,Ajah,adeniki olotu street ilajie ajah ilaje ajah lagos,1,10,5,5,5,1,1,0,1,8,31500000
457,Ajah,seaside estate badore ajah lagos,1,2,1,1,1,0,0,0,1,1,4200000
458,Ajah,"20 ganiyu ikotun street, marshy hill estate ajah okun ajah ajah lagos",1,4,2,2,2,1,1,0,1,4,8400000
459,Ajah,okera-nla lekki ajah lagos ado ajah lagos,1,2,1,1,1,0,0,0,1,1,4200000
460,Ajah,- graceland estate ajah lagos,1,2,1,1,1,1,0,0,1,1,4725000
461,Ajah,olokonla olokonla ajah lagos,1,7,4,3,4,1,1,1,1,5,15750000
462,Ajah,first unity estate cooperative villa badore addo badore ajah lagos,1,6,3,3,3,0,0,0,1,4,9450000
463,Ajah,ado road ado ajah lagos,1,2,1,1,1,1,1,1,1,1,5250000
464,Ajah,prince leye close ado ajah lagos,1,4,2,2,2,1,1,0,1,4,8400000
465,Ajah,sangotedo sangotedo ajah lagos,1,11,6,5,6,1,1,0,1,9,42000000
466,Ajah,sangotedo sangotedo ajah lagos,1,9,5,4,5,1,1,0,1,8,31500000
467,Ajah,mobil road ilaje ajah lagos,1,5,3,2,3,1,1,0,1,4,10500000
468,Ajah," penisula garden estate, few houses away from police post peninsula estate ajah lagos",1,10,5,5,5,1,1,0,1,8,31500000
469,Ajah,sangotedo sangotedo ajah lagos,1,7,4,3,4,0,0,0,1,5,12600000
470,Ajah," agungi, ajah lagos",1,2,1,1,1,1,1,1,1,1,10500000
471,Ajah,peninsula gardens estate sangotedo ajah lagos,1,6,3,3,3,1,1,1,1,4,21000000
472,Ajah,awoyaya ajah lagos,1,8,4,4,4,1,1,1,1,5,21000000
473,Ajah,divine homesl thomas estate ajah lagos,1,10,5,5,5,1,1,0,1,8,31500000
474,Ajah,keji olajide street majek sangotedo ajah lagos,1,7,4,3,4,0,0,0,1,5,12600000
475,Ajah," keji olajide street, majek sangotedo ajah lagos",1,5,3,2,3,0,0,0,1,4,9450000
476,Ajah,23 james wood street ajah lagos,1,6,3,3,3,1,1,1,1,4,24150000
477,Ajah,ajah lekki gardens estate ajah lagos,1,10,5,5,5,1,1,1,1,8,52500000
478,Ajah," abijo gra, ajah lagos abijo ajah lagos",1,15,8,7,8,1,1,0,1,10,57750000
479,Ajah,university view estate opposite lagos business school off lekki epe expressway ajah lagos,1,2,1,1,1,1,1,1,1,1,5250000
480,Lekki,.... ikate lekki lagos,2,7,4,3,4,0,0,0,1,7,26250000
481,Lekki,lekki phase 1 lekki lagos,2,7,4,3,4,1,1,1,1,7,36750000
482,Lekki,ologolo lekki lagos,2,7,4,3,4,0,0,0,1,7,26250000
483,Lekki,lekki phase 1 lekki lagos,2,9,5,4,5,1,1,1,1,9,57750000
484,Lekki,ikate elegushi lekki ikate lekki lagos,2,9,5,4,5,1,0,0,1,9,42000000
485,Lekki,lekki phase 1 lekki lagos,2,7,4,3,4,1,1,1,1,7,45150000
486,Lekki,osapa london lekki lagos,2,7,4,3,4,0,0,0,0,7,24150000
487,Lekki,ikota lekki lagos,2,9,5,4,5,0,0,0,1,9,36750000
488,Lekki,ikate lekki lagos,2,7,4,3,4,0,0,0,0,7,21000000
489,Lekki,lekki phase 1 lekki lagos,2,7,4,3,4,1,1,1,1,7,42000000
490,Lekki,lekki phase 1 lekki lagos,2,7,4,3,4,0,0,0,1,7,26250000
491,Lekki,ikota lekki lagos,2,5,3,2,3,0,0,0,0,7,16800000
492,Lekki,ikota villa estate lekki phase 2 lekki lagos,2,11,6,5,6,0,0,0,0,10,49350000
493,Lekki,lekki phase 1 lekki lagos,2,8,4,4,4,0,0,0,1,7,29400000
494,Lekki,kajola estate ibeju lekki lagos,2,7,4,3,4,0,0,0,0,7,21000000
495,Lekki,lekki phase 1 lekki lagos,2,7,4,3,4,1,1,1,1,7,45150000
496,Lekki,lekki phase 1 lekki lagos,2,7,4,3,4,1,1,1,1,7,45150000
497,Lekki,osapa london lekki lagos,2,5,3,2,3,1,1,0,1,7,26250000
498,Lekki,lekki phase 1 lekki lagos,2,7,4,3,4,1,1,1,1,7,36750000
499,Lekki,lekki phase 1 lekki lagos,2,7,4,3,4,1,1,1,1,7,45150000
500,Lekki,westend estate ikota lekki lagos,2,13,7,6,7,0,0,0,0,10,57750000
501,Lekki,ikota lekki lagos,2,7,4,3,4,0,0,0,1,7,27300000
502,Lekki,lekki phase 1 lekki lagos,2,11,6,5,6,0,0,0,0,10,49350000
503,Lekki,lekki phase 1 lekki lagos,2,11,6,5,6,1,1,0,1,10,65100000
504,Lekki,osapa lekki phase 1 lekki lagos,2,7,4,3,4,0,0,0,0,7,24150000
505,Lekki,lekki phase 1 lekki lagos,2,5,3,2,3,0,0,0,1,7,25200000
506,Lekki,"  lakowe gulf resort eatate, sixk tiger close ibeju lekki lagos",2,8,4,4,4,1,0,0,1,7,31500000
507,Lekki,"6, abimbola owodunni close, seaside estate, off badore road, ajah, lekki, lagos. badore ajah lagos",2,7,4,3,4,0,0,0,0,7,21000000
508,Lekki,alpha beach road igbo efon lekki lagos,2,7,4,3,4,0,0,0,1,7,28350000
509,Lekki,igbo efon lekki lagos,2,7,4,3,4,0,0,0,0,7,21000000
510,Lekki,oral estate lekki lagos,2,11,6,5,6,0,0,0,0,10,49350000
511,Lekki,chevron lekki lagos,2,11,6,5,6,0,0,0,0,10,49350000
512,Lekki,"u3 estate, akinleye street lekki phase 1 lekki lagos",2,9,5,4,5,1,1,1,1,9,58800000
513,Lekki,lekki phase 1 lekki lagos,2,7,4,3,4,0,0,0,1,7,26250000
514,Lekki,lekki phase 1 lekki lagos,2,5,3,2,3,1,1,0,1,7,26250000
515,Lekki,lekki phase 1 lekki lagos,2,5,3,2,3,1,1,0,1,7,26250000
516,Lekki,babatunde anjouse lekki phase 1 lekki lagos,2,9,5,4,5,1,1,1,1,9,52500000
517,Lekki,chevron lekki lagos,2,9,5,4,5,0,0,0,1,9,36750000
518,Lekki,chevron lekki lagos,2,9,5,4,5,1,0,0,1,9,42000000
519,Lekki,osapa london lekki lagos,2,7,4,3,4,1,0,0,1,7,31500000
520,Lekki,osapa london lekki lagos,2,9,5,4,5,1,0,0,1,9,42000000
521,Lekki,lekki right oniru lekki lagos,2,3,2,1,2,1,0,0,1,6,17850000
522,Lekki,ikota lekki lagos,2,7,4,3,4,0,0,0,0,7,21000000
523,Lekki,lekki phase 1 lekki lagos,2,7,4,3,4,1,1,1,1,7,45150000
524,Lekki,osapa london lekki lagos,2,9,5,4,5,1,0,0,1,9,42000000
525,Lekki,osapa london lekki lagos,2,11,6,5,6,0,0,0,0,10,49350000
526,Lekki,"  off orchid hotel road, lafiaji lekki lagos",2,9,5,4,5,0,0,0,1,9,36750000
527,Lekki,lekki phase 1 lekki lagos,2,11,6,5,6,0,0,0,1,10,63000000
528,Lekki,megamound estate ikota lekki lagos,2,9,5,4,5,0,0,0,1,9,36750000
529,Lekki,ologolo lekki lagos,2,9,5,4,5,1,0,0,1,9,42000000
530,Lekki,lekki phase 1 lekki lagos,2,9,5,4,5,0,0,0,1,9,36750000
531,Lekki,chevron lekki lagos,2,9,5,4,5,0,0,0,1,9,37800000
532,Lekki,lekki phase 1 lekki lagos,2,7,4,3,4,0,0,0,1,7,26250000
533,Lekki,lekki phase 1 lekki lagos,2,11,6,5,6,1,1,0,1,10,65100000
534,Lekki,lekki phase 1 lekki lagos,2,11,6,5,6,1,1,0,1,10,65100000
535,Lekki,orchid lekki lagos,2,9,5,4,5,1,1,1,1,9,52500000
536,Lekki,lekki phase 1 lekki lagos,2,5,3,2,3,1,1,1,1,7,29400000
537,Lekki,lekki phase 1 lekki lagos,2,7,4,3,4,1,1,1,1,7,36750000
538,Lekki,lekki phase 1 lekki lagos,2,7,4,3,4,0,0,0,1,7,28350000
539,Lekki,lekki phase 1 lekki lagos,2,7,4,3,4,1,1,1,1,7,36750000
540,Lekki,lekki phase 1 lekki lagos,2,9,5,4,5,1,1,1,1,9,58800000
541,Lekki,lekki phase 1 lekki lagos,2,7,4,3,4,0,0,0,1,7,26250000
542,Lekki,lekki phase 1 lekki lagos,2,11,6,5,6,0,0,0,1,10,63000000
543,Lekki,off orchid road lekki lagos,2,11,6,5,6,0,0,0,0,10,49350000
544,Lekki,lekki phase 1 lekki lagos,2,12,6,6,6,1,1,0,1,10,65100000
545,Lekki,lekki phase 1 lekki lagos,2,7,4,3,4,0,0,0,1,7,26250000
546,Lekki,lekki phase 1 lekki lagos,2,11,6,5,6,1,1,0,1,10,65100000
547,Lekki,chevron lekki lagos,2,7,4,3,4,0,0,0,0,7,21000000
548,Lekki,agungi lekki phase 2 lekki lagos,2,2,1,1,1,0,0,0,1,4,8400000
549,Lekki,lekki phase 1 lekki lagos,2,7,4,3,4,0,0,0,1,7,26250000
550,Lekki,lekki lagos,2,2,1,1,1,0,0,0,0,4,6825000
551,Lekki,lekki phase 1 lekki lagos,2,9,5,4,5,1,1,1,1,9,52500000
552,Lekki,bera estate chevron lekki lagos,2,9,5,4,5,0,0,0,1,9,36750000
553,Lekki,lekki phase 1 lekki lagos,2,11,6,5,6,0,0,0,1,10,63000000
554,Lekki,lekki phase 1 lekki lagos,2,8,5,3,5,0,0,0,1,9,36750000
555,Lekki,lekki phase 1 lekki lagos,2,11,6,5,6,1,1,0,1,10,65100000
556,Lekki,lekki phase 1 lekki lagos,2,11,6,5,6,0,0,0,1,10,57750000
557,Lekki,... lekki phase 1 lekki lagos,2,9,5,4,5,1,1,1,1,9,58800000
558,Lekki,lekki phase 1 lekki lagos,2,9,5,4,5,1,1,1,1,9,52500000
559,Lekki,chevron lekki lagos,2,9,5,4,5,0,0,0,1,9,36750000
560,Lekki,lekki phase 1 lekki lagos,2,11,6,5,6,0,0,0,0,10,52500000
561,Lekki,lekki phase 1 lekki lagos,2,9,5,4,5,1,0,0,1,9,42000000
562,Lekki,lafiaji lekki lagos,2,7,4,3,4,0,0,0,0,7,24150000
563,Lekki,... osapa london lekki lagos,2,9,5,4,5,0,0,0,1,9,36750000
564,Lekki,lafiaji community lekki lagos,2,4,2,2,2,0,0,0,0,6,9450000
565,Lekki,lekki phase 1 lekki lagos,2,7,4,3,4,1,1,1,1,7,45150000
566,Lekki,- lekki phase 1 lekki lagos,2,5,3,2,3,1,1,1,1,7,31500000
567,Lekki,ikate lekki lagos,2,7,4,3,4,0,0,0,1,7,26250000
568,Lekki,chevron lekki lagos,2,9,5,4,5,1,0,1,1,9,47250000
569,Lekki,lekki lekki lagos,2,2,1,1,1,1,1,1,1,4,17850000
570,Lekki,osapa london lekki lagos,2,9,5,4,5,1,0,0,1,9,42000000
571,Lekki,ikota lekki lagos,2,11,6,5,6,1,1,0,1,10,65100000
572,Lekki,chevron lekki lagos,2,9,5,4,5,0,0,0,1,9,36750000
573,Lekki,osapa london lekki lagos,2,7,4,3,4,0,0,0,1,7,26250000
574,Lekki,lekki phase 1 lekki lagos,2,7,4,3,4,1,0,0,1,7,31500000
575,Lekki,ikate lekki lagos,2,11,6,5,6,0,0,0,1,10,63000000
576,Lekki,lekki phase 1 lekki lagos,2,5,3,2,3,0,0,0,1,7,21000000
577,Lekki,.. lekki phase 1 lekki lagos,2,11,6,5,6,1,1,0,1,10,65100000
578,Lekki,lekki phase 1 lekki lagos,2,9,5,4,5,1,1,1,1,9,52500000
579,Lekki,westend estate ikota lekki lagos,2,7,4,3,4,0,0,0,0,7,21000000
580,Lekki,ikate lekki lagos,2,5,3,2,3,0,0,0,1,7,21000000
581,Lekki,lekki palm city ajah lagos,2,11,6,5,6,0,0,0,0,10,49350000
582,Lekki,lekki phase 1 lekki lagos,2,11,6,5,6,0,0,0,0,10,52500000
583,Lekki,lekki phase 1 lekki lagos,2,2,1,1,1,1,1,1,1,4,18900000
584,Lekki,"  buena vista estate, lekki lekki lagos",2,9,5,4,5,0,0,0,1,9,36750000
585,Lekki,osapa london lekki lagos,2,9,5,4,5,0,0,0,1,9,36750000
586,Lekki,lekki phase 1 lekki lagos,2,9,5,4,5,1,0,1,1,9,47250000
587,Lekki,.. lekki phase 1 lekki lagos,2,11,6,5,6,1,1,0,1,10,65100000
588,Lekki,agungi lekki lagos,2,7,4,3,4,1,0,0,1,7,31500000
589,Lekki,lekki phase 1 lekki lagos,2,9,5,4,5,1,0,0,1,9,42000000
590,Lekki,dreamworld africana way lekki phase 2 lekki lagos,2,11,6,5,6,0,0,0,0,10,49350000
591,Lekki,jakande lekki lagos,2,11,6,5,6,1,1,0,1,10,65100000
592,Lekki,ikota lekki lagos,2,5,3,2,3,0,0,0,0,7,16800000
593,Lekki,chevron lekki lagos,2,9,5,4,5,1,0,1,1,9,47250000
594,Lekki,nicon town lekki lagos,2,9,5,4,5,1,1,1,1,9,58800000
595,Lekki,lekki phase 1 lekki lagos,2,9,5,4,5,1,1,1,1,9,52500000
596,Lekki,lekki phase 1 lekki lagos,2,11,6,5,6,0,0,0,1,10,63000000
597,Lekki,chevron lekki lagos,2,5,3,2,3,0,0,0,1,7,21000000
598,Lekki,ikate lekki lagos,2,11,6,5,6,0,0,0,0,10,52500000
599,Lekki,off oladimeji alo lekki phase 1 lekki lagos,2,7,4,3,4,1,1,1,1,7,45150000
600,Lekki,agungi lekki lagos,2,9,5,4,5,0,0,0,1,9,36750000
601,Lekki,off admiralty road lekki. lekki phase 1 lekki lagos,2,7,4,3,4,1,1,1,1,7,45150000
602,Lekki,lekki phase 1 lekki lagos,2,7,4,3,4,1,1,1,1,7,36750000
603,Lekki,ologolo lekki lagos,2,9,5,4,5,0,0,0,1,9,36750000
604,Lekki,orchid lekki phase 2 lekki lagos,2,9,5,4,5,1,0,1,1,9,47250000
605,Lekki,providence lekki phase 1 lekki lagos,2,4,2,2,2,1,1,1,1,6,29400000
606,Lekki,hakkem dickson lekki phase 1 lekki lagos,2,7,4,3,4,1,1,1,1,7,36750000
607,Lekki,ikate ikate lekki lagos,2,9,5,4,5,1,1,1,1,9,52500000
608,Lekki,lekki phase 1 lekki lagos,2,9,5,4,5,1,1,1,1,9,58800000
609,Lekki,off omorihnre johnson lekki phase 1 lekki lagos,2,7,4,3,4,0,0,0,1,7,29400000
610,Lekki,zone b nicon town nicon town lekki lagos,2,11,6,5,6,1,1,0,1,10,65100000
611,Lekki,idado lekki lagos,2,7,4,3,4,1,1,1,1,7,45150000
612,Lekki,lekki phase 1 lekki lagos,2,3,2,1,2,1,0,0,1,6,18900000
613,Lekki,idado lekki lagos,2,9,5,4,5,1,0,1,1,9,47250000
614,Lekki,osapa lekki lagos,2,9,5,4,5,0,0,0,1,9,36750000
615,Lekki,lekki county homes ikota lekki lagos,2,11,6,5,6,1,1,0,1,10,65100000
616,Lekki,"  immediately after shoprite, sangotedo, lekki, lagos crown estate ajah lagos",2,9,5,4,5,0,0,0,1,9,36750000
617,Lekki,off rahman adeboyejo lekki phase 1 lekki lagos,2,11,6,5,6,1,1,0,1,10,65100000
618,Lekki,chevron lekki lagos,2,9,5,4,5,1,0,1,1,9,47250000
619,Lekki,ologolo lekki lagos,2,9,5,4,5,0,0,0,1,9,36750000
620,Lekki,lekki phase 1 lekki lagos,2,15,8,7,8,1,1,0,1,10,73500000
621,Lekki,agungi lekki lagos,2,9,5,4,5,0,0,0,1,9,36750000
622,Lekki,oral estate lekki lagos,2,9,5,4,5,0,0,0,1,9,36750000
623,Lekki,idado lekki lagos,2,5,3,2,3,1,1,0,1,7,26250000
624,Lekki,lekki county home lekki phase 2 lekki lagos,2,9,5,4,5,0,0,0,1,9,36750000
625,Lekki,"  within cooplag estate, along orchid hotel road chevron lekki lagos",2,11,6,5,6,0,0,0,0,10,49350000
626,Lekki,safecourt apartments next to spar ikate lekki lagos,2,7,4,3,4,1,0,0,1,7,31500000
627,Lekki,lekki phase 1 lekki lagos,2,11,6,5,6,1,1,0,1,10,65100000
628,Lekki,chevron lekki lagos,2,9,5,4,5,0,0,0,1,9,36750000
629,Lekki,"off dsc street ,lekki right. lekki phase 1 lekki lagos",2,5,3,2,3,1,1,1,1,7,31500000
630,Lekki,"off dsc, lekki right. lekki phase 1 lekki lagos",2,5,3,2,3,1,1,0,1,7,26250000
631,Lekki,lekki phase 1 lekki lagos,2,7,4,3,4,1,1,1,1,7,36750000
632,Lekki,osapa london lekki lagos,2,9,5,4,5,0,0,0,1,9,38850000
633,Lekki,ikate lekki lagos,2,11,6,5,6,0,0,0,1,10,63000000
634,Lekki,ikate lekki lagos,2,11,6,5,6,0,0,0,0,10,49350000
635,Lekki,off white sand school road. lekki phase 1 lekki lagos,2,7,4,3,4,0,0,0,1,7,29400000
636,Lekki,lekki phase 1 lekki lagos,2,9,5,4,5,1,0,0,1,9,42000000
637,Lekki,lekki phase 1 lekki lagos,2,5,3,2,3,1,1,1,1,7,31500000
638,Lekki,lafiaji lekki lagos,2,9,5,4,5,0,0,0,1,9,36750000
639,Lekki,- lekki phase 1 lekki lagos,2,9,5,4,5,1,1,1,1,9,57750000
640,Lekki,"lekki phase 1, lekki lekki phase 1 lekki lagos",2,6,3,3,3,1,1,1,1,7,36750000
641,Lekki,chevron alternative road chevron lekki lagos state nigeria chevron lekki lagos,2,8,4,4,4,1,0,0,1,7,31500000
642,Lekki,professor kumi st lekki phase 1 lekki lagos,2,8,4,4,4,1,1,1,1,7,45150000
643,Lekki,chevron lekki lagos,2,11,6,5,6,0,0,0,1,10,57750000
644,Lekki,off admiralty way lekki phase 1 lekki lagos,2,5,3,2,3,1,1,0,1,7,26250000
645,Lekki,lekki right ikate lekki lagos,2,7,4,3,4,1,1,1,1,7,36750000
646,Lekki,"  safe court estate, ikate lekki lagos",2,7,4,3,4,1,0,0,1,7,31500000
647,Lekki,agungi agungi lekki lagos,2,7,4,3,4,0,0,0,1,7,26250000
648,Lekki,eletu osapa london lekki lagos,2,11,6,5,6,0,0,0,0,10,49350000
649,Lekki,ilasan ilasan lekki lagos,2,5,3,2,3,0,0,0,0,7,17850000
650,Lekki,safe court estate ikate lekki lagos,2,7,4,3,4,1,0,0,1,7,31500000
651,Lekki,lekki paradise chevron lekki lagos,2,7,4,3,4,1,1,1,1,7,36750000
652,Lekki,close to shoprite jakande lekki lagos,2,9,5,4,5,1,0,0,1,9,42000000
653,Lekki,lekki phase 2 lekki lagos,2,7,4,3,4,0,0,0,0,7,24150000
654,Lekki,lekki phase 1 lekki phase 1 lekki lagos,2,11,6,5,6,1,1,0,1,10,65100000
655,Lekki,orchid road chevron lekki lagos,2,7,4,3,4,0,0,0,1,7,26250000
656,Lekki,ikate lekki lagos,2,5,3,2,3,0,0,0,1,7,24150000
657,Lekki,off admiralty way lekki phase 1 lekki lagos,2,11,6,5,6,1,1,0,1,10,65100000
658,Lekki,eletu osapa london lekki lagos,2,7,4,3,4,0,0,0,1,7,26250000
659,Lekki,ikota villa ikota lekki lagos,2,7,4,3,4,0,0,0,0,7,21000000
660,Lekki,"  pinnock beach estate, osapa london lekki lagos",2,9,5,4,5,1,0,1,1,9,47250000
661,Lekki,idado idado lekki lagos,2,7,4,3,4,0,0,0,0,7,21000000
662,Lekki,"  eletu street, jakande jakande lekki lagos",2,3,2,1,2,0,0,0,1,6,15750000
663,Lekki,chevron lekki lagos,2,9,5,4,5,1,0,1,1,9,47250000
664,Lekki,admiralty home estate igbo efon lekki lagos,2,9,5,4,5,0,0,0,1,9,36750000
665,Lekki,allan allan balogun street osapa london lekki lagos,2,8,4,4,4,1,0,0,1,7,31500000
666,Lekki,lekki county ikota lekki lagos,2,2,1,1,1,0,0,0,0,4,6825000
667,Lekki,orchid road victoria crest estate ikota lekki lagos,2,10,5,5,5,0,0,0,1,9,36750000
668,Lekki,orchid chevron lekki lagos,2,9,5,4,5,0,0,0,1,9,36750000
669,Lekki,off admiralty way lekki phase 1 lekki lagos,2,7,4,3,4,1,1,1,1,7,45150000
670,Lekki,off admiralty way lekki phase 1 lekki lagos,2,7,4,3,4,0,0,0,1,7,26250000
671,Lekki,. lekki phase 1 lekki lagos,2,10,5,5,5,0,0,0,1,9,36750000
672,Lekki,off admiralty way lekki phase 1 lekki lagos,2,4,2,2,2,0,0,0,0,6,10500000
673,Lekki,"  abijo gra, lekki, lagos abijo ajah lagos",2,14,6,8,6,0,0,0,0,10,49350000
674,Lekki,igbo efon lekki lagos,2,7,4,3,4,0,0,0,0,7,21000000
675,Lekki,chisco road ikate lekki lagos,2,7,4,3,4,0,0,0,0,7,24150000
676,Lekki,lekki lekki phase 1 lekki lagos,2,7,4,3,4,1,1,1,1,7,45150000
677,Lekki,lekki right lekki phase 1 lekki lagos,2,11,6,5,6,0,0,0,1,10,63000000
678,Lekki,chevron lekki lagos,2,11,6,5,6,0,0,0,0,10,49350000
679,Lekki,ologolo ologolo lekki lagos,2,9,5,4,5,0,0,0,1,9,36750000
680,Lekki,agungi agungi lekki lagos,2,7,4,3,4,0,0,0,1,7,26250000
681,Lekki,"  eleganza bus stop, orchid road. ikota lekki lagos",2,7,4,3,4,0,0,0,1,7,26250000
682,Lekki,ikate lekki lagos,2,2,1,1,1,0,0,0,0,4,7350000
683,Lekki,lekki phase 1 lekki lagos,2,9,5,4,5,1,0,1,1,9,47250000
684,Lekki,off admiralty way lekki phase 1 lekki lagos,2,5,3,2,3,0,0,0,1,7,21000000
685,Lekki,- chevron lekki lagos,2,8,4,4,4,1,1,1,1,7,42000000
686,Lekki,oral estate lekki phase 2 lekki lagos,2,5,3,2,3,0,0,0,0,7,16800000
687,Lekki,oral estate oral estate lekki lagos,2,3,2,1,2,0,0,0,1,6,15750000
688,Lekki,chevron lekki lagos,2,2,1,1,1,0,0,0,0,4,6825000
689,Lekki,chevron lekki lagos,2,11,6,5,6,0,0,0,0,10,49350000
690,Lekki,... ikate lekki lagos,2,9,5,4,5,0,0,0,1,9,36750000
691,Lekki,chevron lekki lagos,2,9,5,4,5,0,0,0,1,9,36750000
692,Lekki,ikate lekki lagos,2,5,3,2,3,1,1,0,1,7,26250000
693,Lekki,orchid road lekki phase 2 lekki lagos,2,5,3,2,3,1,1,0,1,7,26250000
694,Lekki,lekki phase 1 lekki phase 1 lekki lagos,2,7,4,3,4,0,0,0,1,7,26250000
695,Lekki,ikate-lekki ikate lekki lagos,2,9,6,3,6,1,1,0,1,10,65100000
696,Lekki,off admiralty way lekki phase 1 lekki lagos,2,5,3,2,3,0,0,0,1,7,21000000
697,Lekki,"  bourdillon court, chevron drive chevron lekki lagos",2,9,5,4,5,1,0,0,1,9,42000000
698,Lekki,"  cadogan estate, osapa london lekki lagos",2,7,4,3,4,1,1,1,1,7,39900000
699,Lekki,eletu osapa london lekki lagos,2,7,4,3,4,0,0,0,0,7,21000000
700,Lekki,lekki lekki phase 1 lekki lagos,2,5,3,2,3,1,1,1,1,7,36750000
701,Lekki,ilasan ilasan lekki lagos,2,7,4,3,4,0,0,0,0,7,21000000
702,Lekki,ikate lekki lagos,2,2,1,1,1,0,0,0,0,4,6825000
703,Lekki,lekki paradise chevron lekki lagos,2,9,5,4,5,0,0,0,1,9,36750000
704,Lekki,muritala eletu osapa london lekki lagos,2,7,4,3,4,0,0,0,0,7,21000000
705,Lekki,ikate lekki lagos,2,10,5,5,5,1,1,1,1,9,58800000
706,Lekki,eletu osapa london lekki lagos,2,5,3,2,3,0,0,0,1,7,21000000
707,Lekki,whitesands street lekki phase 1 lekki lagos,2,9,5,4,5,1,1,1,1,9,57750000
708,Lekki,lekki phase 1 lekki lagos,2,2,1,1,1,0,0,0,1,4,10500000
709,Lekki,"  occen bay estate off ,ochid road ikota ikota lekki lagos",2,5,3,2,3,0,0,0,1,7,21000000
710,Lekki,agungi lekki lagos,2,7,4,3,4,0,0,0,0,7,21000000
711,Lekki,"  eleganza gardens, vgc lekki lagos",2,5,3,2,3,0,0,0,0,7,14700000
712,Lekki,ikota villa estate ikota lekki lagos,2,5,3,2,3,0,0,0,0,7,15750000
713,Lekki,vgc vgc lekki lagos,2,9,5,4,5,0,0,0,1,9,36750000
714,Lekki,osapa london lekki lagos,2,11,6,5,6,0,0,0,0,10,49350000
715,Lekki,lekki phase 2 lekki lagos,2,5,3,2,3,0,0,0,0,7,16800000
716,Lekki,chevy view chevron lekki lagos,2,2,1,1,1,0,0,0,0,4,4200000
717,Lekki,chevron lekki lagos,2,9,5,4,5,0,0,0,1,9,36750000
718,Lekki,"  ikota villa estate, megamound ikota lekki lagos",2,8,4,4,4,0,0,0,1,7,26250000
719,Lekki,lekki paradise chevron lekki lagos,2,9,5,4,5,1,1,1,1,9,52500000
720,Lekki,ikota gra ikota lekki lagos,2,7,4,3,4,0,0,0,0,7,21000000
721,Lekki,off admiralty way lekki phase 1 lekki lagos,2,5,3,2,3,1,1,1,1,7,29400000
722,Lekki,"5street estate,agungi agungi lekki lagos",2,8,4,4,4,1,0,0,1,7,31500000
723,Lekki,off admiralty way lekki phase 1 lekki lagos,2,4,2,2,2,1,1,1,1,6,23100000
724,Lekki,off admiralty way lekki phase 1 lekki lagos,2,7,4,3,4,0,0,0,1,7,26250000
725,Lekki,close to prime water estate ikate lekki lagos,2,7,4,3,4,0,0,0,1,7,26250000
726,Lekki,pinnock beach estate osapa london lekki lagos,2,7,4,3,4,0,0,0,0,7,21000000
727,Lekki,bishop's court ikate lekki lagos,2,9,5,4,5,0,0,0,1,9,36750000
728,Lekki,ikota villa estate ikota lekki lagos,2,9,5,4,5,0,0,0,1,9,36750000
729,Lekki,"  osapa, osapa london lekki lagos",2,9,5,4,5,0,0,0,1,9,36750000
730,Lekki,"  richmond gate estate, ikate lekki lagos",2,9,5,4,5,1,1,1,1,9,52500000
731,Lekki,lekki lekki phase 1 lekki lagos,2,9,5,4,5,1,0,0,1,9,42000000
732,Lekki,lekki phase 1 lekki lagos,2,5,3,2,3,0,0,0,0,7,17850000
733,Lekki,off kusenla ikate lekki lagos,2,8,4,4,4,1,1,1,1,7,45150000
734,Lekki,pinnock beach luxury estate osapa london lekki lagos,2,14,7,7,7,0,0,0,1,10,68250000
735,Lekki,ikota ikota lekki lagos,2,5,3,2,3,0,0,0,0,7,16800000
736,Lekki,oral estate oral estate lekki lagos,2,5,3,2,3,0,0,0,0,7,18900000
737,Lekki,off admiralty way lekki phase 1 lekki lagos,2,9,5,4,5,1,1,1,1,9,58800000
738,Lekki,eletu osapa london lekki lagos,2,7,4,3,4,0,0,0,0,7,21000000
739,Lekki,... lekki phase 1 lekki lagos,2,2,1,1,1,1,1,1,1,4,14700000
740,Lekki,"  pinnock beach estate, osapa london lekki lagos",2,11,6,5,6,1,1,0,1,10,65100000
741,Lekki,lekki paradise chevron lekki lagos,2,7,4,3,4,0,0,0,1,7,26250000
742,Lekki,chevy view chevron lekki lagos,2,2,1,1,1,0,0,0,0,4,4200000
743,Lekki,ikota villa estate ikota lekki lagos,2,2,1,1,1,0,0,0,0,4,5250000
744,Lekki,bera estate off chevron drive chevron lekki lagos,2,9,5,4,5,0,0,0,1,9,36750000
745,Lekki,ikota lekki lagos,2,5,3,2,3,0,0,0,0,7,17850000
746,Lekki,off admiralty way lekki phase 1 lekki lagos,2,9,5,4,5,1,1,1,1,9,57750000
747,Lekki,orchid road oral estate lekki lagos,2,9,5,4,5,1,1,1,1,9,52500000
748,Lekki,ilasan lekki lagos,2,5,3,2,3,0,0,0,0,7,15750000
749,Lekki,"  chevyview estate, chevron lekki lagos",2,7,4,3,4,0,0,0,0,7,21000000
750,Lekki,ikota lekki lagos,2,9,5,4,5,0,0,0,1,9,36750000
751,Lekki,off admiralty way lekki phase 1 lekki lagos,2,3,2,1,2,0,0,0,1,6,15750000
752,Lekki,"  eleganza garden, opposite vgc vgc lekki lagos",2,7,3,4,3,1,1,0,1,7,26250000
753,Lekki,osapa london lekki lagos,2,5,3,2,3,1,1,0,1,7,26250000
754,Lekki,"  eleganza gardens, vgc lekki lagos",2,3,2,1,2,0,0,0,0,6,11550000
755,Lekki,"  cromwell estate, chevron lekki lagos",2,7,4,3,4,0,0,0,1,7,29400000
756,Lekki,behind prime water gardens ikate lekki lagos,2,7,4,3,4,0,0,0,0,7,23100000
757,Lekki,"updc estate, lekki phase 1 lekki lagos",2,7,4,3,4,1,1,1,1,7,45150000
758,Lekki,mega chicken ikota lekki lagos,2,9,5,4,5,0,0,0,1,9,36750000
759,Lekki,bridge gate estate agungi lekki lagos,2,9,5,4,5,0,0,0,1,9,36750000
760,Lekki,orchid road chevron lekki lagos,2,9,5,4,5,0,0,0,1,9,36750000
761,Lekki,idado lekki lagos,2,11,6,5,6,0,0,0,0,10,49350000
762,Lekki,ologolo lekki lagos,2,5,3,2,3,0,0,0,1,7,21000000
763,Lekki,lekki right side lekki phase 1 lekki lagos,2,7,4,3,4,1,0,0,1,7,33600000
764,Lekki,pinnock beach estate osapa london lekki lagos,2,12,6,6,6,1,1,0,1,10,65100000
765,Lekki,romay garden estate ilasan lekki lagos,2,9,5,4,5,0,0,0,1,9,36750000
766,Lekki,megamound estate ikota lekki lagos,2,9,5,4,5,0,0,0,1,9,36750000
767,Lekki,"  safe court apartments, ikate lekki lagos",2,7,4,3,4,1,1,1,1,7,36750000
768,Lekki,"  bourdillon court, chevron lekki lagos",2,7,4,3,4,1,0,0,1,7,31500000
769,Lekki,ikota lekki lagos,2,7,4,3,4,0,0,0,0,7,21000000
770,Lekki,"tom ogboi street,off freedom way lekki phase 1 lekki phase 1 lekki lagos",2,7,4,3,4,1,0,0,1,7,31500000
771,Lekki,off freedom way lekki phase 1 lekki phase 1 lekki lagos,2,11,6,5,6,0,0,0,0,10,52500000
772,Lekki,lekki phase 1 lekki lagos,2,8,4,4,4,1,1,1,1,7,36750000
773,Lekki,olofin street off admiralty road. lekki phase 1 lekki lagos,2,3,2,1,2,1,0,0,1,6,17850000
774,Lekki,chile mba close behinde zenith bank. osapa london lekki lagos,2,9,5,4,5,1,0,0,1,9,42000000
775,Lekki,oladimeji alo lekki phase 1 lekki lagos,2,2,1,1,1,1,0,0,1,4,12600000
776,Lekki,ikate lekki lagos,2,3,2,1,2,0,0,0,1,6,15750000
777,Lekki,oral estate lekki lagos,2,7,4,3,4,0,0,0,0,7,21000000
778,Lekki,orchid road ikota lekki lagos,2,9,5,4,5,0,0,0,1,9,36750000
779,Lekki,off freedom way lekki phase 1 lekki lagos,2,9,5,4,5,1,0,0,1,9,42000000
780,Lekki,off admiralty road lekki phase 1 lekki phase 1 lekki lagos,2,5,3,2,3,0,0,0,1,7,25200000
781,Lekki,oral zone 1 lekki garden ikate lekki lagos,2,7,4,3,4,1,0,0,1,7,31500000
782,Lekki,oral estate lekki lagos,2,3,2,1,2,0,0,0,1,6,15750000
783,Lekki,chisco off world oil fueling station. ilasan lekki lagos,2,7,4,3,4,0,0,0,0,7,23100000
784,Lekki,off admiralty way lekki phase 1 lekki lagos,2,9,4,5,4,1,1,1,1,7,45150000
785,Lekki,"  safecourt estate, ikate-elegushi, lagos. ikate lekki lagos",2,7,4,3,4,1,0,0,1,7,31500000
786,Lekki,jakande lekki lagos,2,9,5,4,5,1,1,1,1,9,58800000
787,Lekki,lekki phase 1 lekki lagos,2,11,6,5,6,1,1,0,1,10,65100000
788,Lekki,"  chevron,lekki expressway lekki lagos",2,9,5,4,5,0,0,0,1,9,36750000
789,Lekki,off admiralty way lekki phase 1 lekki lagos,2,9,5,4,5,1,0,1,1,9,47250000
790,Lekki,off admiralty way lekki phase 1 lekki lagos,2,9,5,4,5,1,1,1,1,9,58800000
791,Lekki,bosola durosinmi etti drive lekki phase 1 lekki lagos,2,11,6,5,6,0,0,0,1,10,63000000
792,Lekki,off admiralty way lekki phase 1 lekki lagos,2,9,5,4,5,1,1,1,1,9,58800000
793,Lekki,west ends estates ikota lekki lagos,2,9,5,4,5,0,0,0,1,9,36750000
794,Lekki,off bisola durotimi etti lekki phase 1 lekki lagos,2,7,4,3,4,0,0,0,1,7,26250000
795,Lekki,admiralty way lekki phase 1 lekki lagos,2,7,4,3,4,1,1,1,1,7,45150000
796,Lekki,lekki phase 1 lekki lagos,2,11,6,5,6,1,1,0,1,10,65100000
797,Lekki,ikota lekki lagos,2,11,6,5,6,0,0,0,0,10,49350000
798,Lekki,cadogan estate jakande lekki lagos,2,7,4,3,4,1,0,0,1,7,31500000
799,Lekki,lekki county homes lekki lagos,2,9,5,4,5,1,1,1,1,9,58800000
800,Lekki,megamound estate ikota lekki lagos,2,9,5,4,5,0,0,0,1,9,36750000
801,Lekki,ikota villa estate lekki lagos,2,9,5,4,5,0,0,0,1,9,36750000
802,Lekki,ikate lekki lagos,2,13,7,6,7,0,0,0,1,10,63000000
803,Lekki,lekki phase 1 lekki lagos,2,8,4,4,4,1,1,1,1,7,36750000
804,Lekki,lekki phase 1 lekki lagos,2,2,1,1,1,1,1,1,1,4,14700000
805,Lekki,lekki phase 1 lekki lagos,2,7,4,3,4,1,1,1,1,7,45150000
806,Lekki,"  chevron road,lekki expressway chevron lekki lagos",2,9,5,4,5,0,0,0,1,9,36750000
807,Lekki,off admiralty way lekki phase 1 lekki lagos,2,9,5,4,5,1,1,1,1,9,58800000
808,Lekki,lekki phase 1 lekki lagos,2,11,6,5,6,1,1,0,1,10,65100000
809,Lekki,off fola osibo road lekki phase 1 lekki lagos,2,7,4,3,4,1,0,0,1,7,31500000
810,Lekki,osapa london lekki lagos,2,10,5,5,5,0,0,0,1,9,36750000
811,Lekki,off fola osibo lekki phase 1 lekki lagos,2,3,2,1,2,1,1,1,1,6,31500000
812,Lekki,orchid road lekki lagos,2,9,5,4,5,1,0,0,1,9,42000000
813,Lekki,off admiralty way lekki phase 1 lekki lagos,2,9,5,4,5,1,1,1,1,9,57750000
814,Lekki,off admirality way lekki phase 1 lekki lagos,2,9,5,4,5,1,1,1,1,9,52500000
815,Lekki,iroko awe elegushi lekki ilasan lekki lagos,2,2,1,1,1,0,0,0,0,4,7350000
816,Lekki,orchid hotel road. lekki phase 2 lekki lagos,2,10,5,5,5,0,0,0,1,9,36750000
817,Lekki,osapa london lekki osapa london lekki lagos,2,7,4,3,4,0,0,0,1,7,26250000
818,Lekki,ikota villa estate by mega chicken ikota lekki lagos,2,7,4,3,4,0,0,0,0,7,21000000
819,Lekki,lekki conservative road ikota before 2nd toll gate chevron lekki lagos,2,9,5,4,5,0,0,0,1,9,36750000
820,Lekki,igbo efon lekki lagos,2,5,3,2,3,0,0,0,0,7,15750000
821,Lekki,"horizon 11,by meadow hall way ikate elegushi lekki ikate lekki lagos",2,7,4,3,4,0,0,0,1,7,28875000
822,Lekki,fairview estate orchid hotel road chevron drive lekki lekki lagos,2,9,5,4,5,0,0,0,1,9,36750000
823,Lekki,alpha beach road new road (sea view estate) chevron lekki lagos,2,7,4,3,4,0,0,0,0,7,21000000
824,Lekki,off admiralty way lekki phase 1 lekki lagos,2,5,3,2,3,1,1,1,1,7,36750000
825,Lekki,van daniel road by eleganza bustop chevron lekki lagos,2,2,1,1,1,0,0,0,0,4,5250000
826,Lekki,greenville estate agungi lekki lagos,2,2,1,1,1,0,0,0,0,4,4200000
827,Lekki,rose rock estate orchid road chevron drive lekki chevron lekki lagos,2,9,5,4,5,0,0,0,1,9,36750000
828,Lekki,close to victory park estate osapa london osapa london lekki lagos,2,7,4,3,4,0,0,0,1,7,26250000
829,Lekki,directly on spg road opposite argungi lekki ologolo lekki lagos,2,7,4,3,4,0,0,0,0,7,21000000
830,Lekki,chevy view estate off chevron drive chevron lekki lagos,2,7,4,3,4,0,0,0,0,7,21000000
831,Lekki,off road 12 lekki phase one lekki phase 1 lekki lagos,2,3,2,1,2,0,0,0,0,6,9450000
832,Lekki,lekki phase 1 lekki lagos,2,7,4,3,4,1,0,0,1,7,31500000
833,Lekki,idado lekki lagos,2,5,3,2,3,0,0,0,0,7,15750000
834,Lekki,environment agungi lekki lagos,2,2,1,1,1,0,0,0,0,4,5250000
835,Lekki,alpha beach road chevron drive lekki chevron lekki lagos,2,5,3,2,3,0,0,0,0,7,15750000
836,Lekki,"  alpha beach road, new road chevron drive lekki chevron lekki lagos",2,7,4,3,4,0,0,0,0,7,25200000
837,Lekki,... osapa london lekki lagos,2,5,3,2,3,0,0,0,0,7,17850000
838,Lekki,in an estate by second toll gate oral estate lekki lagos,2,6,3,3,3,0,0,0,1,7,21000000
839,Lekki,buena vista estate orchid road chevron drive lekki lagos chevron lekki lagos,2,9,5,4,5,0,0,0,1,9,36750000
840,Lekki,bogije ibeju lekki lagos,2,5,3,2,3,0,0,0,0,7,10500000
841,Lekki,new creation street 2nd round about by pinnacle petrol station lekki phase 1 lekki lagos,2,3,2,1,2,0,0,0,1,6,16800000
842,Lekki,esther adeleke lekki phase 1 lekki lagos,2,7,4,3,4,0,0,0,1,7,27300000
843,Lekki,lekki phase 1 lekki lagos,2,9,5,4,5,0,0,0,1,9,36750000
844,Lekki,around dominoes pizza agungi lekki lagos,2,2,1,1,1,0,0,0,1,4,10500000
845,Lekki,.. lekki phase 1 lekki lagos,2,3,2,1,2,1,0,0,1,6,17850000
846,Lekki,chevron alternative routes lekki chevron lekki lagos,2,8,4,4,4,0,0,0,0,7,21000000
847,Lekki,in an estate osapa london osapa london lekki lagos,2,7,4,3,4,1,0,0,1,7,31500000
848,Lekki,grand view estate argungi lekki agungi lekki lagos,2,9,5,4,5,0,0,0,1,9,36750000
849,Lekki,u3 estate by petrocam filling station lekki right lekki phase 1 lekki lagos,2,5,3,2,3,0,0,0,1,7,24150000
850,Lekki,by marwa bustop (just immediately after lekki phase 1) lekki phase 1 lekki lagos,2,2,1,1,1,0,0,0,0,4,4200000
851,Lekki,safecourts estate ikate ikate lekki lagos,2,8,5,3,5,0,0,0,1,9,36750000
852,Lekki,the address home jakande lekki jakande lekki lagos,2,9,5,4,5,1,1,1,1,9,57750000
853,Lekki,prime water garden ikate lekki lagos,2,7,4,3,4,1,1,1,1,7,36750000
854,Lekki,by abraham adesanya estate lekki gardens estate ajah lagos,2,7,4,3,4,0,0,0,0,7,21000000
855,Lekki,close to domino pizza agungi lekki lagos,2,3,2,1,2,0,0,0,0,6,9450000
856,Lekki,igbo efon lekki igbo efon lekki lagos,2,3,2,1,2,0,0,0,0,6,10500000
857,Lekki,off durosinmi etti lekki phase 1 lekki lagos,2,11,6,5,6,0,0,0,0,10,49350000
858,Lekki,prime water view estate 2 ikate elegushi lekki lagos ikate lekki lagos,2,9,5,4,5,1,1,1,1,9,52500000
859,Lekki,yeye olofin lekki phase one lekki phase 1 lekki lagos,2,3,2,1,2,0,0,0,1,6,15750000
860,Lekki,off freedom way lekki phase one lagos lekki phase 1 lekki lagos,2,3,2,1,2,0,0,0,0,6,14700000
861,Lekki,off tf kuboye street lekki phase one lekki phase 1 lekki lagos,2,7,4,3,4,1,0,0,1,7,31500000
862,Lekki,amen estate eleko ibeju lekki eleko ibeju lekki lagos,2,3,2,1,2,0,0,0,0,6,9450000
863,Lekki,amen estate eleko ibeju lekki lagos,2,9,5,4,5,1,0,1,1,9,47250000
864,Lekki,ilasan lekki lagos,2,9,5,4,5,0,0,0,1,9,36750000
865,Lekki,chevron lekki lagos,2,11,6,5,6,0,0,0,0,10,49350000
866,Lekki,chevron lekki lagos,2,9,5,4,5,0,0,0,1,9,36750000
867,Lekki,lekki phase 1 lekki lagos,2,9,5,4,5,1,1,1,1,9,52500000
868,Lekki,lekki phase 1 lekki lagos,2,11,6,5,6,1,1,0,1,10,65100000
869,Lekki,osapa london lekki lagos,2,5,3,2,3,0,0,0,0,7,17850000
870,Lekki,ikate lekki lagos,2,9,5,4,5,0,0,0,1,9,36750000
871,Lekki,agungi lekki lagos,2,9,5,4,5,0,0,0,1,9,36750000
872,Lekki,ologolo lekki lagos,2,3,2,1,2,0,0,0,1,6,15750000
873,Lekki,ikota villa estate ikota lekki lagos,2,9,5,4,5,0,0,0,1,9,36750000
874,Lekki,jakande lekki lagos,2,7,4,3,4,0,0,0,1,7,29400000
875,Lekki,lekki phase 1 lekki lagos,2,9,5,4,5,1,1,1,1,9,58800000
876,Lekki,lekki phase 1 lekki lagos,2,7,4,3,4,1,0,0,1,7,31500000
877,Lekki,ikota lekki lagos,2,7,4,3,4,0,0,0,0,7,21000000
878,Lekki,lekki phase 1 lekki lagos,2,11,6,5,6,1,1,0,1,10,65100000
879,Lekki,lekki phase 1 lekki lagos,2,9,5,4,5,1,1,1,1,9,52500000
880,Lekki,agungi lekki lagos,2,9,5,4,5,0,0,0,1,9,36750000
881,Lekki,osapa london lekki lagos,2,7,4,3,4,0,0,0,0,7,21000000
882,Lekki,idado lekki lagos,2,11,6,5,6,0,0,0,0,10,49350000
883,Lekki,ikate lekki lagos,2,5,3,2,3,0,0,0,1,7,21000000
884,Lekki,ikota lekki lagos,2,9,5,4,5,0,0,0,1,9,36750000
885,Lekki,ikate lekki lagos,2,5,3,2,3,1,1,0,1,7,26250000
886,Lekki,chevron lekki lagos,2,7,4,3,4,1,0,0,1,7,31500000
887,Lekki,lekki phase 1 lekki lagos,2,3,2,1,2,0,0,0,0,6,9450000
888,Lekki,idado lekki lagos,2,7,4,3,4,0,0,0,0,7,21000000
889,Lekki,agungi lekki lagos,2,7,4,3,4,0,0,0,0,7,21000000
890,Lekki,lekki phase 1 lekki lagos,2,7,4,3,4,0,0,0,1,7,28350000
891,Lekki,lekki phase 1 lekki lagos,2,10,5,5,5,1,1,1,1,9,52500000
892,Lekki,ikate lekki lagos,2,9,5,4,5,0,0,0,1,9,36750000
893,Lekki,lekki phase 1 lekki lagos,2,7,4,3,4,0,0,0,0,7,21000000
894,Lekki,lekki phase 1 lekki lagos,2,9,5,4,5,1,1,1,1,9,58800000
895,Lekki,ikota lekki lagos,2,9,5,4,5,0,0,0,1,9,36750000
896,Lekki,lafiaji lekki lagos,2,7,4,3,4,0,0,0,1,7,26250000
897,Lekki,ikate lekki lagos,2,5,3,2,3,0,0,0,1,7,21000000
898,Lekki,jakande lekki lagos,2,9,5,4,5,0,0,0,1,9,36750000
899,Lekki,ikota lekki lagos,2,7,4,3,4,0,0,0,0,7,21000000
900,Lekki,osapa london lekki lagos,2,8,4,4,4,1,0,0,1,7,31500000
901,Lekki,ikate lekki lagos,2,11,6,5,6,0,0,0,1,10,63000000
902,Lekki,lafiaji lekki lagos,2,5,3,2,3,0,0,0,0,7,18900000
903,Lekki,ikate lekki lagos,2,9,5,4,5,0,0,0,1,9,36750000
904,Lekki,idado lekki lagos,2,7,4,3,4,0,0,0,0,7,21000000
905,Lekki,ologolo lekki lagos,2,7,4,3,4,0,0,0,0,7,21000000
906,Lekki,bera estate chevron lekki lagos,2,9,5,4,5,0,0,0,1,9,36750000
907,Lekki,lekki phase 1 lekki lagos,2,3,2,1,2,0,0,0,0,6,13650000
908,Lekki,lekki phase 1 lekki lagos,2,3,2,1,2,1,0,0,1,6,18900000
909,Lekki,eru-ifa ikate lekki lagos,2,7,4,3,4,1,0,0,1,7,31500000
910,Lekki,lekki phase 1 lekki lagos,2,11,6,5,6,0,0,0,1,10,63000000
911,Lekki,orchid lafiaji lekki lekki lagos,2,9,5,4,5,0,0,0,1,9,36750000
912,Lekki,igbo efon lekki lagos,2,7,4,3,4,0,0,0,0,7,21000000
913,Lekki,lekki phase 1 lekki lagos,2,3,2,1,2,0,0,0,1,6,15750000
914,Lekki,lekki lekki phase 1 lekki lagos,2,8,4,4,4,1,1,1,1,7,36750000
915,Lekki,"lekki phase 1,right lekki phase 1 lekki lagos",2,9,5,4,5,1,1,1,1,9,57750000
916,Lekki,lafiaji lekki lagos,2,9,5,4,5,0,0,0,1,9,36750000
917,Lekki,chevy view estate lekki chevron lekki lagos,2,9,5,4,5,0,0,0,1,9,36750000
918,Lekki,lekki county homes lekki abule egba lagos,2,7,4,3,4,1,1,1,1,7,45150000
919,Lekki,chevron lekki chevron lekki lagos,2,9,5,4,5,0,0,0,1,9,36750000
920,Lekki,off durosimi etti street lekki phase 1 lekki lagos,2,7,4,3,4,1,1,1,1,7,36750000
921,Lekki,ologolo lekki lagos,2,5,3,2,3,0,0,0,0,7,13650000
922,Lekki,chevron chevron lekki lagos,2,7,4,3,4,0,0,0,0,7,21000000
923,Lekki,lekki phase 1 lekki lagos,2,7,4,3,4,1,1,1,1,7,38850000
924,Lekki,ajiran rd agungi lekki lagos,2,2,1,1,1,0,0,0,1,4,10500000
925,Lekki,orchid lekki phase 2 lekki lagos,2,9,5,4,5,1,0,1,1,9,47250000
926,Lekki,off victoria arubieke. lekki phase 1 lekki lagos,2,2,1,1,1,1,1,1,1,4,17850000
927,Lekki,fatai arubieke street lekki phase 1 lekki lagos,2,7,4,3,4,1,1,1,1,7,42000000
928,Lekki,lekki phase 1 lekki lagos,2,9,5,4,5,1,1,1,1,9,52500000
929,Lekki,idado lekki lagos,2,7,4,3,4,0,0,0,0,7,21000000
930,Lekki,lekki phase 1 lekki lagos,2,11,6,5,6,0,0,0,1,10,57750000
931,Lekki,lekki phase 1 lekki lagos,2,5,3,2,3,1,1,0,1,7,26250000
932,Lekki,grace anjounse lekki phase 1 lekki lagos,2,5,3,2,3,1,1,1,1,7,31500000
933,Lekki,agungi lekki agungi lekki lagos,2,9,5,4,5,0,0,0,1,9,36750000
934,Lekki,chief collins lekki phase 1 lekki lagos,2,5,3,2,3,1,1,0,1,7,26250000
935,Lekki,orchid road oral estate lekki lagos,2,5,3,2,3,0,0,0,0,7,18900000
936,Lekki,lekki phase 1 lekki lagos,2,11,6,5,6,0,0,0,1,10,63000000
937,Lekki,off admiralty road lekki phase 1 lekki lagos,2,9,5,4,5,1,1,1,1,9,52500000
938,Lekki,off admiralty road lekki phase 1 lekki lagos,2,7,4,3,4,0,0,0,1,7,28350000
939,Lekki,phase 1 lekki phase 1 lekki lagos,2,7,4,3,4,1,1,1,1,7,36750000
940,Lekki,lekki right lekki phase 1 lekki lagos,2,7,4,3,4,0,0,0,1,7,26250000
941,Lekki,... chevron lekki lagos,2,11,6,5,6,0,0,0,0,10,49350000
942,Lekki,lekki phase 1 lekki lagos,2,7,4,3,4,0,0,0,1,7,26250000
943,Lekki,ikota lekki lagos,2,5,3,2,3,0,0,0,0,7,13650000
944,Lekki,ikate lekki lagos,2,11,6,5,6,0,0,0,1,10,63000000
945,Lekki,chevron lekki lagos,2,9,5,4,5,1,0,0,1,9,42000000
946,Lekki,ikota lekki lagos,2,11,6,5,6,0,0,0,0,10,49350000
947,Lekki,lekki phase 1 lekki lagos,2,7,4,3,4,0,0,0,1,7,26250000
948,Lekki,lekki phase 1 lekki lagos,2,9,5,4,5,0,0,0,1,9,36750000
949,Lekki,jakande lekki lagos,2,7,4,3,4,0,0,0,1,7,26250000
950,Lekki,lekki phase one lekki phase 1 lekki lagos,2,4,2,2,2,1,0,0,1,6,18900000
951,Lekki,ikate lekki lagos,2,10,5,5,5,1,1,1,1,9,52500000
952,Lekki,lekki phase 1 lekki lagos,2,4,2,2,2,0,0,0,0,6,12600000
953,Lekki,behind prime water ikate lekki lagos,2,5,3,2,3,0,0,0,1,7,21000000
954,Lekki,off fola osibo lekki phase 1 lekki lagos,2,7,4,3,4,1,0,0,1,7,31500000
955,Lekki,ikota estate ikota lekki lagos,2,5,3,2,3,0,0,0,1,7,21000000
956,Lekki,idado idado lekki lagos,2,3,2,1,2,0,0,0,0,6,13650000
957,Lekki,idado idado lekki lagos,2,7,4,3,4,0,0,0,0,7,21000000
958,Lekki,bourdillion court chevron lekki lagos,2,7,4,3,4,1,0,0,1,7,31500000
959,Lekki,lekki garden. chevron 2 chevron lekki lagos,2,9,5,4,5,0,0,0,1,9,36750000
960,Lekki,"lekki garden phase 2,opposite abraham adesanya abraham adesanya estate ajah lagos",2,7,4,3,4,0,0,0,0,7,21000000
961,Lekki,ikota villa ikota lekki lagos,2,7,4,3,4,0,0,0,0,7,21000000
962,Lekki,lekki phase 1 lekki lagos,2,11,6,5,6,1,1,0,1,10,65100000
963,Lekki,.. lekki phase 1 lekki lagos,2,7,4,3,4,0,0,0,1,7,26250000
964,Lekki,lekki phase 1 lekki lagos,2,7,4,3,4,0,0,0,1,7,29400000
965,Lekki,ikate lekki lagos,2,11,6,5,6,1,1,0,1,10,65100000
966,Lekki,ikate lekki lagos,2,5,3,2,3,0,0,0,1,7,21000000
967,Lekki,osapa london lekki lagos,2,9,5,4,5,0,0,0,1,9,36750000
968,Lekki,osapa london lekki lagos,2,11,6,5,6,0,0,0,0,10,49350000
969,Lekki,osapa lekki phase 2 lekki lagos,2,11,6,5,6,0,0,0,0,10,52500000
970,Lekki,ikota lekki lagos,2,9,5,4,5,0,0,0,1,9,36750000
971,Lekki,ikate ikate lekki lagos,2,7,4,3,4,1,1,1,1,7,36750000
972,Lekki,spa road ologolo lekki lagos,2,7,4,3,4,0,0,0,0,7,21000000
973,Lekki,.. lekki phase 1 lekki lagos,2,4,2,2,2,1,1,1,1,6,31500000
974,Lekki,lekki phase 1 lekki lagos,2,4,2,2,2,1,0,0,1,6,17850000
975,Lekki,ikota lekki lagos,2,9,5,4,5,0,0,0,1,9,36750000
976,Lekki,ikate lekki lagos,2,7,4,3,4,0,0,0,1,7,26250000
977,Lekki,orchid lekki lagos,2,7,4,3,4,0,0,0,1,7,26250000
978,Lekki,off admiralty way lekki phase 1 lekki lagos,2,9,5,4,5,1,0,0,1,9,42000000
979,Lekki,orchid lekki phase 2 lekki lagos,2,9,5,4,5,0,0,0,1,9,36750000
980,Lekki,spg road igbo efon lekki lagos,2,3,2,1,2,0,0,0,0,6,9450000
981,Lekki,chevy view chevron lekki lagos,2,7,4,3,4,0,0,0,0,7,23100000
982,Lekki,idado idado lekki lagos,2,7,4,3,4,0,0,0,1,7,26250000
983,Lekki,osapa london lekki lagos,2,7,4,3,4,0,0,0,0,7,21000000
984,Lekki,alpha beach lekki lagos,2,7,4,3,4,0,0,0,0,7,21000000
985,Lekki,lekki lekki phase 1 lekki lagos,2,9,5,4,5,1,0,0,1,9,42000000
986,Lekki,chevy view estate chevron lekki lagos,2,2,1,1,1,0,0,0,1,4,10500000
987,Lekki,agungi lekki lagos,2,7,4,3,4,0,0,0,0,7,21000000
988,Lekki,oral estate oral estate lekki lagos,2,7,4,3,4,0,0,0,0,7,21000000
989,Lekki,off admiralty way lekki phase 1 lekki lagos,2,7,4,3,4,1,1,1,1,7,42000000
990,Lekki,idado estate chevron lekki lagos,2,11,6,5,6,0,0,0,0,10,49350000
991,Lekki,ikate lekki lagos,2,11,6,5,6,0,0,0,1,10,63000000
992,Lekki,.. lekki phase 1 lekki lagos,2,5,3,2,3,0,0,0,1,7,23100000
993,Lekki,bourdillon court chevron lekki lagos,2,9,5,4,5,0,0,0,1,9,36750000
994,Lekki," lakowe, otunla ibeju lekki lagos",2,5,3,2,3,0,0,0,0,7,10500000
995,Lekki,chevron lekki lagos,2,9,5,4,5,0,0,0,1,9,36750000
996,Lekki,lekki phase 1 lekki lagos,2,2,1,1,1,1,0,0,1,4,12600000
997,Lekki,lekki phase 1 lekki lagos,2,6,3,3,3,1,1,1,1,7,36750000
998,Lekki,jakande lekki lagos,2,7,4,3,4,0,0,0,1,7,26250000
999,Lekki,lekki phase 1 lekki lagos,2,9,5,4,5,1,1,1,1,9,57750000
1000,Lekki,agungi lekki lagos,2,7,4,3,4,0,0,0,0,7,21000000
1001,Lekki,- lekki phase 1 lekki lagos,2,7,4,3,4,1,1,1,1,7,45150000
1002,Lekki,off providence road lekki phase 1 lekki lagos,2,2,1,1,1,1,1,1,1,4,15750000
1003,Lekki,adebayo doherty lekki phase 1 lekki lagos,2,7,4,3,4,1,1,1,1,7,36750000
1004,Lekki,william st chevron lekki lagos,2,9,5,4,5,0,0,0,1,9,36750000
1005,Lekki,ikota lekki lagos,2,9,5,4,5,0,0,0,1,9,36750000
1006,Lekki,off admiralty way lekki phase 1 lekki lagos,2,7,4,3,4,1,1,1,1,7,36750000
1007,Lekki,off admiralty way lekki phase 1 lekki lagos,2,7,4,3,4,0,0,0,1,7,26250000
1008,Lekki,off admiralty way lekki phase 1 lekki lagos,2,7,4,3,4,1,0,0,1,7,31500000
1009,Lekki,off admiralty way lekki phase 1 lekki lagos,2,7,4,3,4,1,0,0,1,7,31500000
1010,Lekki,off admiralty way lekki phase 1 lekki lagos,2,7,4,3,4,1,1,1,1,7,36750000
1011,Lekki,... ikate lekki lagos,2,7,4,3,4,1,1,1,1,7,42000000
1012,Lekki,... chevron lekki lagos,2,11,6,5,6,0,0,0,0,10,49350000
1013,Lekki,nicon town lekki lagos,2,9,5,4,5,0,0,0,1,9,36750000
1014,Lekki,osapa lekki phase 1 lekki lagos,2,9,5,4,5,1,0,0,1,9,42000000
1015,Lekki,lekki phase 1 lekki lagos,2,11,6,5,6,1,1,0,1,10,65100000
1016,Lekki,osapa london lekki lagos,2,7,4,3,4,1,1,1,1,7,36750000
1017,Lekki,lekki lekki phase 1 lekki lagos,2,7,4,3,4,1,0,0,1,7,31500000
1018,Lekki,- lekki phase 1 lekki lagos,2,7,4,3,4,0,0,0,1,7,28350000
1019,Lekki,lekki phase 1 estate lekki phase 1 lekki lagos,2,11,6,5,6,1,1,0,1,10,65100000
1020,Lekki,- lekki phase 1 lekki lagos,2,7,4,3,4,0,0,0,1,7,26250000
1021,Lekki,lekki phase 1 lekki lagos,2,4,2,2,2,1,1,1,1,6,26250000
1022,Lekki,jakande lekki lagos,2,10,5,5,5,0,0,0,1,9,36750000
1023,Lekki,ikota villa ikota lekki lagos,2,8,4,4,4,0,0,0,1,7,26250000
1024,Lekki,ikate lekki lagos,2,10,5,5,5,1,1,1,1,9,57750000
1025,Lekki,osapa london lekki lagos,2,9,5,4,5,0,0,0,1,9,36750000
1026,Lekki,lekki phase 1 lekki lagos,2,7,4,3,4,1,1,1,1,7,36750000
1027,Lekki,lekki phase 1 lekki lagos,2,5,3,2,3,0,0,0,1,7,25200000
1028,Lekki,lekki phase 1 lekki lagos,2,11,6,5,6,1,1,0,1,10,65100000
1029,Lekki,.. agungi lekki lagos,2,4,2,2,2,1,1,1,1,6,21000000
1030,Lekki,chevy view chevron lekki lagos,2,8,4,4,4,1,1,1,1,7,42000000
1031,Lekki,- lekki phase 1 lekki lagos,2,7,4,3,4,0,0,0,1,7,29400000
1032,Lekki,agungi lekki lagos,2,9,5,4,5,0,0,0,1,9,36750000
1033,Lekki,orchid lekki lagos,2,9,5,4,5,0,0,0,1,9,36750000
1034,Lekki,chevron lekki lagos,2,11,6,5,6,0,0,0,0,10,52500000
1035,Lekki,ilasan lekki lagos,2,5,3,2,3,0,0,0,1,7,23100000
1036,Lekki,- agungi lekki lagos,2,5,3,2,3,0,0,0,1,7,21000000
1037,Lekki,lekki phase 1 lekki lagos,2,7,4,3,4,1,0,0,1,7,31500000
1038,Lekki,ologolo lekki lagos,2,9,5,4,5,0,0,0,1,9,36750000
1039,Lekki,ikota lekki lagos,2,9,5,4,5,0,0,0,1,9,36750000
1040,Lekki,chevron lekki lagos,2,7,4,3,4,0,0,0,1,7,26250000
1041,Lekki,ologolo lekki lagos,2,9,5,4,5,0,0,0,1,9,36750000
1042,Lekki,lekki phase 1 lekki lagos,2,7,4,3,4,1,1,1,1,7,42000000
1043,Lekki,lekki phase 1 lekki lagos,2,9,5,4,5,1,0,1,1,9,47250000
1044,Lekki,chisco ikate lekki lagos,2,11,6,5,6,0,0,0,0,10,49350000
1045,Lekki,osapa osapa london lekki lagos,2,9,5,4,5,1,1,1,1,9,58800000
1046,Lekki," lucky osujie, lekki palm city estate ado ajah lagos",2,9,5,4,5,0,0,0,1,9,36750000
1047,Lekki,kanal residence osapa london lekki lagos,2,9,5,4,5,0,0,0,1,9,36750000
1048,Lekki,primewater estate ikate lekki lagos,2,7,4,3,4,0,0,0,1,7,26250000
1049,Lekki,ikota ikota lekki lagos,2,9,5,4,5,0,0,0,1,9,36750000
1050,Lekki,off admiralty road lekki phase 1 lekki lagos,2,2,1,1,1,1,1,1,1,4,14700000
1051,Lekki,gbola salami agungi lekki lagos,2,7,4,3,4,0,0,0,0,7,21000000
1052,Lekki,ikota villa estate ikota lekki lagos,2,7,4,3,4,0,0,0,0,7,21000000
1053,Lekki,jinadu igbo efon lekki lagos,2,7,4,3,4,0,0,0,0,7,21000000
1054,Lekki," safe court estate, beside spar, ikate lekki lagos",2,7,4,3,4,1,0,0,1,7,31500000
1055,Lekki,osapa london lekki lagos,2,5,3,2,3,0,0,0,0,7,15750000
1056,Lekki,lekki phase 1 lekki lagos,2,10,5,5,5,1,0,0,1,9,42000000
1057,Lekki,lekki phase 1 lekki lagos,2,7,4,3,4,0,0,0,1,7,26250000
1058,Lekki,lekki phase 1 lekki lagos,2,5,3,2,3,1,1,1,1,7,36750000
1059,Lekki,spg road ologolo lekki lagos,2,7,4,3,4,0,0,0,0,7,21000000
1060,Lekki,lekki phase 1 lekki lagos,2,3,2,1,2,1,1,1,1,6,26250000
1061,Lekki,osapa london lekki lagos,2,7,4,3,4,0,0,0,1,7,26250000
1062,Lekki,off ola dimeji alo lekki phase 1 lekki lagos,2,11,6,5,6,0,0,0,1,10,57750000
1063,Lekki," orchid hotel road, chevron toll gate chevron lekki lagos",2,2,1,1,1,1,1,1,1,4,21000000
1064,Lekki,ikota lekki lagos,2,8,4,4,4,0,0,0,1,7,26250000
1065,Lekki,alpha beach road igbo efon lekki lagos,2,7,4,3,4,0,0,0,0,7,23100000
1066,Lekki,new road igbo efon lekki lagos,2,7,4,3,4,0,0,0,0,7,21000000
1067,Lekki," oluwanisola estate, chevron lekki lagos",2,7,4,3,4,1,0,0,1,7,31500000
1068,Lekki,chevron lekki lagos,2,7,4,3,4,0,0,0,0,7,21000000
1069,Lekki,chevron conservative chevron lekki lagos,2,11,6,5,6,0,0,0,0,10,49350000
1070,Lekki,osapa london lekki lagos,2,2,1,1,1,0,0,0,0,4,7350000
1071,Lekki,off freedom way lekki phase 1 lekki lagos,2,9,5,4,5,1,0,1,1,9,47250000
1072,Lekki,alpha beach road igbo efon lekki lagos,2,7,4,3,4,0,0,0,0,7,21000000
1073,Lekki," ikota villa estate, ikota lekki lagos",2,9,5,4,5,0,0,0,1,9,36750000
1074,Lekki,ikota ikota lekki lagos,2,11,6,5,6,0,0,0,0,10,49350000
1075,Lekki,orchid road ikota lekki lagos,2,9,5,4,5,0,0,0,1,9,36750000
1076,Lekki,lekki phase 1 lekki phase 1 lekki lagos,2,5,3,2,3,1,1,1,1,7,31500000
1077,Lekki,off kunesela road ikate lekki lagos,2,9,5,4,5,1,0,0,1,9,42000000
1078,Lekki,ikate lekki lagos,2,2,1,1,1,0,0,0,0,4,5250000
1079,Lekki,lekki phase 1 lekki lagos,2,7,4,3,4,0,0,0,1,7,26250000
1080,Lekki,ikate ikate lekki lagos,2,7,4,3,4,1,1,1,1,7,36750000
1081,Lekki,... chevron lekki lagos,2,9,5,4,5,1,0,0,1,9,42000000
1082,Lekki,- lekki phase 1 lekki lagos,2,5,3,2,3,1,1,0,1,7,26250000
1083,Lekki,ilasan lekki lagos,2,3,2,1,2,0,0,0,0,6,9450000
1084,Lekki,prime water estate ikate lekki lagos,2,6,3,3,3,1,1,1,1,7,31500000
1085,Lekki,ikota lekki phase 2 lekki lagos,2,9,5,4,5,0,0,0,1,9,36750000
1086,Lekki,phase 1 lekki phase 1 lekki lagos,2,7,4,3,4,1,1,1,1,7,36750000
1087,Lekki,lekki phase 1 lekki lagos,2,7,4,3,4,1,1,1,1,7,36750000
1088,Lekki,off admiralty way lekki phase 1 lekki lagos,2,5,3,2,3,0,0,0,1,7,21000000
1089,Lekki,off admiralty way lekki phase 1 lekki lagos,2,7,4,3,4,0,0,0,1,7,29400000
1090,Lekki,off domino road agungi lekki lagos,2,5,3,2,3,0,0,0,1,7,21000000
1091,Lekki,off durosinmi etti lekki phase 1 lekki lagos,2,7,4,3,4,0,0,0,1,7,26250000
1092,Lekki,off admiralty way lekki phase 1 lekki lagos,2,5,3,2,3,1,1,1,1,7,31500000
1093,Lekki,ologolo ologolo lekki lagos,2,11,6,5,6,1,1,0,1,10,65100000
1094,Lekki,richmond gate estate ikate lekki lagos,2,9,5,4,5,1,1,1,1,9,57750000
1095,Lekki,off admiralty way lekki phase 1 lekki lagos,2,7,4,3,4,0,0,0,1,7,26250000
1096,Lekki,northpointe estate chevron lekki lagos,2,9,5,4,5,0,0,0,1,9,36750000
1097,Lekki,osapa jakande lekki lagos,2,9,5,4,5,0,0,0,1,9,36750000
1098,Lekki,chevron chevron lekki lagos,2,9,5,4,5,0,0,0,1,9,36750000
1099,Lekki,idado idado lekki lagos,2,5,3,2,3,0,0,0,1,7,21000000
1100,Lekki,oral oral estate lekki lagos,2,9,5,4,5,0,0,0,1,9,36750000
1101,Lekki,osapa osapa london lekki lagos,2,7,4,3,4,0,0,0,1,7,26250000
1102,Lekki,salem ilasan lekki lagos,2,7,4,3,4,0,0,0,0,7,21000000
1103,Lekki,lekki phase 1 lekki lagos,2,6,3,3,3,1,1,1,1,7,36750000
1104,Lekki,lekki phase 1 lekki lagos,2,2,1,1,1,1,0,0,1,4,12600000
1105,Lekki,lekki phase 1 lekki lagos,2,2,1,1,1,1,0,0,1,4,12600000
1106,Lekki,chevron lekki lagos,2,5,3,2,3,0,0,0,1,7,21000000
1107,Lekki,ikate ikate lekki lagos,2,7,4,3,4,1,1,1,1,7,36750000
1108,Lekki,jakande lekki lagos,2,6,3,3,3,1,1,0,1,7,26250000
1109,Lekki,orchid road lekki chevron lekki lagos,2,8,4,4,4,1,0,0,1,7,31500000
1110,Lekki,"off victoria arobieke street, phase1 lekki phase 1 lekki lagos",2,8,4,4,4,1,1,1,1,7,36750000
1111,Lekki,.. lekki phase 1 lekki lagos,2,9,5,4,5,1,0,1,1,9,48300000
1112,Lekki,richmond gate estate ikate lekki lagos,2,7,4,3,4,0,0,0,1,7,26250000
1113,Lekki,lekki phase 1 lekki lagos,2,8,4,4,4,0,0,0,1,7,26250000
1114,Lekki,orchid ikota lekki lagos,2,2,1,1,1,1,0,0,1,4,12600000
1115,Lekki,.. ikota lekki lagos,2,4,2,2,2,0,0,0,0,6,12600000
1116,Lekki,agungi lekki lagos,2,8,4,4,4,0,0,0,1,7,26250000
1117,Lekki,ikota lekki lagos,2,9,5,4,5,1,0,0,1,9,42000000
1118,Lekki,maruwa lekki phase 1 lekki lagos,2,7,4,3,4,1,0,0,1,7,31500000
1119,Lekki,agungi lekki lagos,2,7,4,3,4,0,0,0,0,7,21000000
1120,Lekki,ikota lekki lagos,2,9,5,4,5,0,0,0,1,9,36750000
1121,Lekki,... osapa london lekki lagos,2,11,6,5,6,0,0,0,0,10,49350000
1122,Lekki,chevron lekki lagos,2,11,6,5,6,0,0,0,0,10,49350000
1123,Lekki,... osapa london lekki lagos,2,9,5,4,5,0,0,0,1,9,38850000
1124,Lekki,lekki phase 1 lekki lagos,2,7,4,3,4,1,1,1,1,7,36750000
1125,Lekki,lekki phase 1 lekki lagos,2,9,5,4,5,1,1,1,1,9,58800000
1126,Lekki,lekki phase 1 lekki lagos,2,11,6,5,6,1,1,0,1,10,65100000
1127,Lekki,lekki right hand side lekki phase 1 lekki lagos,2,7,4,3,4,1,1,1,1,7,45150000
1128,Lekki,lekki phase 1 lekki lagos,2,7,4,3,4,1,0,0,1,7,31500000
1129,Lekki,lekki phase 1 lekki lagos,2,9,5,4,5,1,1,1,1,9,58800000
1130,Lekki,lekki scheme 2 ajah lagos,2,9,5,4,5,0,0,0,1,9,36750000
1131,Lekki,lekki scheme 2 ajah lagos,2,9,5,4,5,0,0,0,1,9,36750000
1132,Lekki,lekki scheme 2 ajah lagos,2,7,4,3,4,0,0,0,0,7,21000000
1133,Lekki,chevron lekki lagos,2,9,5,4,5,0,0,0,1,9,36750000
1134,Lekki,lekki phase 2 lekki lagos,2,9,5,4,5,0,0,0,1,9,36750000
1135,Lekki," eleganza gardens, vgc lekki lagos",2,7,4,3,4,0,0,0,0,7,21000000
1136,Lekki,chevron lekki lagos,2,7,4,3,4,0,0,0,1,7,26250000
1137,Lekki,off admiralty way lekki phase 1 lekki lagos,2,11,6,5,6,0,0,0,0,10,52500000
1138,Lekki,ikate ikate lekki lagos,2,5,3,2,3,1,1,1,1,7,31500000
1139,Lekki,chevron lekki lagos,2,7,4,3,4,0,0,0,1,7,29400000
1140,Lekki,chevron lekki lagos,2,9,5,4,5,1,0,0,1,9,42000000
1141,Lekki,.. agungi lekki lagos,2,7,4,3,4,0,0,0,0,7,21000000
1142,Lekki,- ikate lekki lagos,2,2,1,1,1,0,0,0,1,4,8557500
1143,Lekki,lekki phase 1 lekki lagos,2,7,4,3,4,1,1,1,1,7,45150000
1144,Lekki,manor garden estate vgc lekki lagos,2,9,5,4,5,0,0,0,1,9,36750000
1145,Lekki,osapa london lekki lagos,2,2,1,1,1,0,0,0,1,4,8400000
1146,Lekki,idado idado lekki lagos,2,5,3,2,3,0,0,0,1,7,21000000
1147,Lekki,ikate lekki lagos,2,7,4,3,4,0,0,0,0,7,21000000
1148,Lekki,... ikate lekki lagos,2,7,4,3,4,1,0,0,1,7,31500000
1149,Lekki,chevron lekki lagos,2,9,5,4,5,0,0,0,1,9,36750000
1150,Lekki,lekki phase 1 lekki phase 1 lekki lagos,2,9,5,4,5,1,1,1,1,9,52500000
1151,Lekki,off admiralty way lekki phase 1 lekki lagos,2,5,3,2,3,1,1,0,1,7,26250000
1152,Lekki,off admiralty way lekki phase 1 lekki lagos,2,7,4,3,4,0,0,0,1,7,29400000
1153,Lekki,off providence road lekki phase 1 lekki lagos,2,9,5,4,5,1,1,1,1,9,58800000
1154,Lekki,.. ikate lekki lagos,2,11,6,5,6,0,0,0,1,10,63000000
1155,Lekki,- lekki phase 1 lekki lagos,2,11,6,5,6,1,1,0,1,10,65100000
1156,Lekki,lekki phase 1 lekki lagos,2,9,5,4,5,1,1,1,1,9,52500000
1157,Lekki,ilasan lekki lagos,2,11,6,5,6,0,0,0,0,10,49350000
1158,Lekki,ikate ikate lekki lagos,2,9,5,4,5,1,0,1,1,9,47250000
1159,Lekki,ologolo lekki lagos,2,7,4,3,4,1,0,0,1,7,31500000
1160,Lekki,spg igbo efon lekki lagos,2,3,2,1,2,0,0,0,0,6,13650000
1161,Lekki,lekki phase 1 lekki lagos,2,5,3,2,3,1,1,1,1,7,31500000
1162,Lekki,lekki phase 1 lekki lagos,2,11,6,5,6,1,1,0,1,10,65100000
1163,Lekki,nicon town lekki lagos,2,11,6,5,6,1,1,0,1,10,65100000
1164,Lekki,lekki phase 1 lekki lagos,2,9,5,4,5,1,1,1,1,9,58800000
1165,Lekki,lekki phase 1 lekki lagos,2,9,5,4,5,1,0,1,1,9,47250000
1166,Lekki,pinnock estate osapa london lekki lagos,2,11,6,5,6,0,0,0,1,10,63000000
1167,Lekki,lekki phase 1 lekki lagos,2,2,1,1,1,1,1,1,1,4,21000000
1168,Lekki,lekki phase 1 lekki lagos,2,2,1,1,1,1,1,1,1,4,21000000
1169,Lekki," car wash bridge, agungi agungi lekki lagos",2,9,5,4,5,0,0,0,1,9,36750000
1170,Lekki,jakande lekki lagos,2,6,3,3,3,1,1,0,1,7,26250000
1171,Lekki,lekki phase 1 lekki lagos,2,6,3,3,3,0,0,0,1,7,23100000
1172,Lekki,lekki phase 1 lekki lagos,2,6,3,3,3,1,1,1,1,7,36750000
1173,Lekki,ikota lekki lagos,2,8,4,4,4,1,1,1,1,7,42000000
1174,Lekki,chevy view chevron lekki lagos,2,2,1,1,1,0,0,0,1,4,10500000
1175,Lekki,lekki phase 1 lekki lagos,2,6,3,3,3,1,1,0,1,7,26250000
1176,Lekki,lekki phase 1 lekki lagos,2,6,3,3,3,1,1,0,1,7,26250000
1177,Lekki,marwa lekki phase 1 lekki lagos,2,6,3,3,3,1,1,1,1,7,31500000
1178,Lekki,osapa london lekki lagos,2,4,2,2,2,1,1,1,1,6,23100000
1179,Lekki,lekki lekki phase 1 lekki lagos,2,7,4,3,4,1,1,1,1,7,45150000
1180,Lekki,lekki lekki phase 1 lekki lagos,2,7,4,3,4,0,0,0,1,7,26250000
1181,Lekki,- lekki phase 1 lekki lagos,2,7,4,3,4,0,0,0,1,7,28350000
1182,Lekki,off admiralty way lekki phase 1 lekki lagos,2,7,4,3,4,1,1,1,1,7,36750000
1183,Lekki,off freedom way lekki phase 1 lekki lagos,2,5,3,2,3,1,1,1,1,7,36750000
1184,Lekki,- lekki phase 1 lekki lagos,2,7,4,3,4,1,1,1,1,7,45150000
1185,Lekki,off admiralty road lekki phase 1 lekki lagos,2,9,5,4,5,1,1,1,1,9,58800000
1186,Lekki,lekki right lekki phase 1 lekki lagos,2,7,4,3,4,1,1,1,1,7,36750000
1187,Lekki,ikota lekki lagos,2,11,6,5,6,0,0,0,0,10,49350000
1188,Lekki,lekki phase 1 lekki lagos,2,7,4,3,4,0,0,0,1,7,26250000
1189,Lekki,chevron lekki lagos,2,7,4,3,4,1,1,1,1,7,36750000
1190,Lekki,ologolo lekki lagos,2,7,4,3,4,0,0,0,0,7,21000000
1191,Lekki,orchid road lekki phase 2 lekki lagos,2,9,5,4,5,0,0,0,1,9,36750000
1192,Lekki,agungi lekki lagos,2,9,5,4,5,0,0,0,1,9,36750000
1193,Lekki,chevron lekki lagos,2,11,6,5,6,0,0,0,0,10,49350000
1194,Lekki,.. ikota lekki lagos,2,5,3,2,3,0,0,0,0,7,12600000
1195,Lekki,mini serviced estate osapa london lekki lagos,2,11,6,5,6,0,0,0,1,10,63000000
1196,Lekki,prime water estate lekki phase 1 lekki lagos,2,7,4,3,4,0,0,0,1,7,26250000
1197,Lekki,osapa osapa london lekki lagos,2,9,5,4,5,0,0,0,1,9,36750000
1198,Lekki,northern foreshore chevron lekki lagos,2,9,5,4,5,0,0,0,1,9,36750000
1199,Lekki,off freedom way ikate lekki lagos,2,7,4,3,4,0,0,0,0,7,21000000
1200,Lekki,off freedom way lekki phase 1 lekki lagos,2,9,5,4,5,0,0,0,1,9,39900000
1201,Lekki,alternative route chevron lekki lagos,2,11,6,5,6,0,0,0,0,10,49350000
1202,Lekki,off freedom way ikate lekki lagos,2,5,3,2,3,0,0,0,1,7,21000000
1203,Lekki,vintage estate close to shoprite jakande lekki lagos,2,9,5,4,5,1,0,0,1,9,42000000
1204,Lekki,ikota lekki lagos,2,9,5,4,5,0,0,0,1,9,36750000
1205,Lekki,osapa lekki phase 2 lekki lagos,2,11,6,5,6,0,0,0,0,10,52500000
1206,Lekki,chevron lekki lagos,2,11,6,5,6,0,0,0,0,10,49350000
1207,Lekki,agungi lekki lagos,2,2,1,1,1,0,0,0,1,4,9450000
1208,Lekki,.. osapa london lekki lagos,2,7,4,3,4,0,0,0,0,7,21000000
1209,Lekki,agungi agungi lekki lagos,2,5,3,2,3,0,0,0,0,7,17850000
1210,Lekki,.. lekki phase 1 lekki lagos,2,11,6,5,6,1,1,0,1,10,65100000
1211,Lekki,lekki phase 1 lekki lagos,2,7,4,3,4,1,1,1,1,7,45150000
1212,Lekki,chevy view chevron lekki lagos,2,11,6,5,6,0,0,0,0,10,49350000
1213,Lekki,chevron chevron lekki lagos,2,7,4,3,4,0,0,0,0,7,23100000
1214,Lekki,lekki phase 1 lekki lagos,2,9,5,4,5,1,1,1,1,9,58800000
1215,Lekki,osapa london lekki lagos,2,2,1,1,1,0,0,0,0,4,6300000
1216,Lekki,- lekki phase 1 lekki lagos,2,7,4,3,4,1,0,0,1,7,31500000
1217,Lekki,lekki phase 1 lekki lagos,2,9,5,4,5,1,0,1,1,9,50400000
1218,Lekki," eleganza gardens, vgc lekki lagos",2,5,3,2,3,0,0,0,0,7,12600000
1219,Lekki,agungi lekki lagos,2,9,5,4,5,0,0,0,1,9,36750000
1220,Lekki,oral oral estate lekki lagos,2,5,3,2,3,0,0,0,0,7,17850000
1221,Lekki,osapa london lekki lagos,2,9,5,4,5,1,0,0,1,9,42000000
1222,Lekki,jakande lekki lagos,2,7,4,3,4,0,0,0,1,7,29400000
1223,Lekki,.. ikota lekki lagos,2,5,3,2,3,0,0,0,0,7,13650000
1224,Lekki,lekki phase 1 lekki lagos,2,9,5,4,5,1,1,1,1,9,57750000
1225,Lekki,- osapa london lekki lagos,2,7,4,3,4,0,0,0,1,7,26250000
1226,Lekki,nicon town lekki lagos,2,11,6,5,6,1,1,0,1,10,65100000
1227,Lekki,lekki phase 1 lekki lagos,2,15,8,7,8,1,1,0,1,10,73500000
1228,Lekki,off admiralty way lekki phase 1 lekki lagos,2,7,4,3,4,1,1,1,1,7,42000000
1229,Lekki,maruwa lekki phase 1 lekki lagos,2,7,4,3,4,0,0,0,1,7,29400000
1230,Lekki,off admiralty way lekki phase 1 lekki lagos,2,7,4,3,4,1,0,0,1,7,34650000
1231,Lekki,pinnock estate osapa london lekki lagos,2,11,6,5,6,0,0,0,1,10,63000000
1232,Lekki,norther foreshore lekki phase 1 lekki lagos,2,8,4,4,4,1,1,1,1,7,36750000
1233,Lekki,osapa london lekki lagos,2,5,3,2,3,0,0,0,0,7,18900000
1234,Lekki,osapa london lekki lagos,2,7,4,3,4,0,0,0,1,7,26250000
1235,Lekki,ikota lekki lagos,2,7,4,3,4,0,0,0,0,7,21000000
1236,Lekki,chevy view estate chevron lekki lagos,2,9,5,4,5,1,0,0,1,9,42000000
1237,Lekki,osapa london lekki lagos,2,7,4,3,4,0,0,0,0,7,21000000
1238,Lekki,lekki phase 1 lekki lagos,2,7,4,3,4,0,0,0,1,7,26250000
1239,Lekki,chevron lekki lagos,2,7,4,3,4,1,0,0,1,7,31500000
1240,Lekki,ikota lekki lagos,2,7,4,3,4,0,0,0,0,7,21000000
1241,Lekki,chevron lekki lagos,2,7,4,3,4,0,0,0,1,7,26250000
1242,Lekki,lekki phase 1 lekki lagos,2,7,4,3,4,1,1,1,1,7,45150000
1243,Lekki,lekki phase 1 lekki lagos,2,7,4,3,4,1,1,1,1,7,42000000
1244,Lekki,lekki phase 1 lekki lagos,2,7,4,3,4,1,1,1,1,7,36750000
1245,Lekki,lekki phase 1 lekki lagos,2,7,4,3,4,1,1,1,1,7,36750000
1246,Lekki,oniru victoria island lagos,2,11,6,5,6,1,1,0,1,10,65100000
1247,Lekki,lekki phase 1 lekki lagos,2,7,4,3,4,1,1,1,1,7,36750000
1248,Lekki,lekki phase 1 lekki lagos,2,12,6,6,6,1,1,0,1,10,65100000
1249,Lekki,.. lekki phase 1 lekki lagos,2,7,4,3,4,1,1,1,1,7,42000000
1250,Lekki,lekki phase 1 lekki lagos,2,7,4,3,4,0,0,0,1,7,26250000
1251,Lekki,chevron lekki lagos,2,2,1,1,1,1,1,1,1,4,15750000
1252,Lekki,chevron lekki lagos,2,7,4,3,4,0,0,0,1,7,26250000
1253,Lekki,richmond gate estate ikate lekki lagos,2,9,5,4,5,1,0,1,1,9,47250000
1254,Lekki,admiralty way lekki phase 1 lekki lagos,2,3,2,1,2,0,0,0,1,6,15750000
1255,Lekki,lekki phase 1 lekki lagos,2,11,6,5,6,0,0,0,1,10,63000000
1256,Lekki,off palace road ikate lekki lagos,2,6,3,3,3,0,0,0,1,7,21000000
1257,Lekki,lekki phase one lekki phase 1 lekki lagos,2,3,2,1,2,0,0,0,1,6,15750000
1258,Lekki,idado idado lekki lagos,2,7,4,3,4,0,0,0,0,7,21000000
1259,Lekki,osapa osapa london lekki lagos,2,5,3,2,3,0,0,0,1,7,24150000
1260,Lekki," ologolo, ologolo lekki lagos",2,7,4,3,4,0,0,0,0,7,21000000
1261,Lekki,lekki phase 1 lekki lagos,2,11,6,5,6,0,0,0,1,10,63000000
1262,Lekki,ikota estate ikota lekki lagos,2,9,5,4,5,0,0,0,1,9,36750000
1263,Lekki,.. ikota lekki lagos,2,10,5,5,5,0,0,0,1,9,36750000
1264,Lekki," golf, lakowe ibeju lekki lagos",2,5,3,2,3,0,0,0,0,7,10500000
1265,Lekki,spring bay estate ikate lekki lagos,2,7,4,3,4,1,1,1,1,7,36750000
1266,Lekki,off admiralty way lekki phase 1 lekki lagos,2,11,6,5,6,1,1,0,1,10,65100000
1267,Lekki,off adebayo dorothy lekki phase 1 lekki lagos,2,5,3,2,3,1,1,0,1,7,26250000
1268,Lekki,off admiralty road lekki phase 1 lekki lagos,2,9,5,4,5,1,1,1,1,9,58800000
1269,Lekki,off admiralty way lekki phase 1 lekki lagos,2,7,4,3,4,1,1,1,1,7,37800000
1270,Lekki,. lekki phase 1 lekki lagos,2,7,4,3,4,0,0,0,0,7,21000000
1271,Lekki,- lekki phase 1 lekki lagos,2,7,4,3,4,1,1,1,1,7,45150000
1272,Lekki,freedom way lekki phase 1 lekki lagos,2,5,3,2,3,0,0,0,0,7,16800000
1273,Lekki,behind tantalizer lekki phase 1 lekki lagos,2,9,5,4,5,1,1,1,1,9,58800000
1274,Lekki,ikota ikota lekki lagos,2,9,5,4,5,0,0,0,1,9,36750000
1275,Lekki,agungi agungi lekki lagos,2,4,2,2,2,1,0,0,1,6,18900000
1276,Lekki,eletu osapa london lekki lagos,2,9,5,4,5,0,0,0,1,9,36750000
1277,Lekki,bridge gate estate agungi lekki lagos,2,2,1,1,1,0,0,0,1,4,8925000
1278,Lekki,chevron lekki lagos,2,8,4,4,4,1,0,0,1,7,31500000
1279,Lekki,chevron alternative chevron lekki lagos,2,10,5,5,5,1,0,0,1,9,42000000
1280,Lekki,oral estate lekki lagos,2,8,4,4,4,1,0,0,1,7,31500000
1281,Lekki,ikota villa ikota lekki lagos,2,8,4,4,4,1,1,1,1,7,42000000
1282,Lekki,lekki phase 1 lekki lagos,2,8,4,4,4,1,0,0,1,7,31500000
1283,Lekki,chevron lekki lagos,2,7,3,4,3,1,1,1,1,7,31500000
1284,Lekki,osapa london lekki lagos,2,11,6,5,6,0,0,0,0,10,49350000
1285,Lekki,off admiralty way lekki phase 1 lekki lagos,2,7,4,3,4,0,0,0,1,7,29400000
1286,Lekki,off admiralty way lekki phase 1 lekki lagos,2,5,3,2,3,1,1,0,1,7,26250000
1287,Lekki,off admiralty way lekki phase 1 lekki lagos,2,5,3,2,3,1,1,1,1,7,31500000
1288,Lekki,ikate estate ikate lekki lagos,2,5,3,2,3,0,0,0,1,7,21000000
1289,Lekki,off admiralty way lekki phase 1 lekki lagos,2,5,3,2,3,1,1,0,1,7,26250000
1290,Lekki,denco court ikate lekki lagos,2,9,5,4,5,0,0,0,1,9,36750000
1291,Lekki,alternative route chevron lekki lagos,2,11,6,5,6,0,0,0,0,10,49350000
1292,Lekki,lekki phase 1 lekki lagos,2,6,3,3,3,1,1,0,1,7,26250000
1293,Lekki,agungi lekki lagos,2,6,3,3,3,0,0,0,0,7,18900000
1294,Lekki,.. jakande lekki lagos,2,4,2,2,2,1,1,1,1,6,21000000
1295,Lekki,lekki phase 1 lekki lagos,2,6,3,3,3,1,1,0,1,7,26250000
1296,Lekki,lekki right lekki phase 1 lekki lagos,2,7,4,3,4,1,1,1,1,7,36750000
1297,Lekki,kajola eleranigbe ibeju lekki lagos,2,7,4,3,4,0,0,0,0,7,21000000
1298,Lekki,ikate ikate lekki lagos,2,7,4,3,4,1,1,1,1,7,39900000
1299,Lekki," milverton estate, lekki lekki lagos",2,6,3,3,3,1,1,0,1,7,26250000
1300,Lekki,chevy view chevron lekki lagos,2,7,4,3,4,0,0,0,1,7,26250000
1301,Lekki,off freedom way ikate lekki lagos,2,5,3,2,3,0,0,0,1,7,24150000
1302,Lekki,agungi agungi lekki lagos,2,5,3,2,3,0,0,0,1,7,24150000
1303,Lekki,ikota lekki lagos,2,9,5,4,5,0,0,0,1,9,36750000
1304,Lekki,ikota lekki lagos,2,2,1,1,1,0,0,0,1,4,8400000
1305,Lekki,osapa london lekki lagos,2,6,3,3,3,0,0,0,0,7,17850000
1306,Lekki," orchid road,chevron tollgate chevron lekki lagos",2,2,1,1,1,0,0,0,0,4,5250000
1307,Lekki,gbetu road awoyaya off lekki epe expressway ajah lagos,2,12,6,6,6,0,0,0,0,10,49350000
1308,Lekki,"tom ogboi street, itedo estate lekki phase 1 lekki lagos",2,3,2,1,2,0,0,0,1,6,16800000
1309,Lekki,"muiz banire street opp imax cinema lekki phase 1, lekki lagos lekki phase 1 lekki lagos",2,7,4,3,4,1,1,1,1,7,45150000
1310,Lekki,elegushi lekki phase 1 lekki lagos,2,7,4,3,4,0,0,0,0,7,21000000
1311,Lekki,elegushi ikate lekki lagos,2,7,4,3,4,0,0,0,0,7,21000000
1312,Lekki,elegushi ikate lekki lagos,2,6,3,3,3,0,0,0,1,7,21000000
1313,Lekki,lekki phase1 lekki phase 1 lekki lagos,2,9,5,4,5,1,1,1,1,9,58800000
1314,Lekki,lekki phase 1 lekki phase 1 lekki lagos,2,9,5,4,5,1,0,0,1,9,42000000
1315,Lekki,... idado lekki lagos,2,7,4,3,4,0,0,0,0,7,21000000
1316,Lekki,off alpha beach road igbo efon lekki lagos,2,11,6,5,6,0,0,0,0,10,49350000
1317,Lekki,ilasan lekki lagos,2,7,4,3,4,0,0,0,0,7,23100000
1318,Lekki,lekki phase1 lekki phase 1 lekki lagos,2,3,2,1,2,1,0,0,1,6,17850000
1319,Lekki,chevy view estate chevron lekki lagos,2,9,5,4,5,0,0,0,1,9,36750000
1320,Lekki,chevron lekki lagos,2,13,7,6,7,0,0,0,0,10,57750000
1321,Lekki,gbangbala street ikate lekki lagos,2,7,4,3,4,0,0,0,1,7,26250000
1322,Lekki,lekki right lekki phase 1 lekki lagos,2,9,5,4,5,1,0,1,1,9,47250000
1323,Lekki,owode alpha beach igbo efon lekki lagos,2,3,2,1,2,0,0,0,0,6,9450000
1324,Lekki,road13 ikota lekki lagos,2,5,3,2,3,0,0,0,0,7,15750000
1325,Lekki,admiralty home estate igbo efon lekki lagos,2,11,6,5,6,0,0,0,0,10,49350000
1326,Lekki,off chevron drive chevron lekki lagos,2,9,5,4,5,0,0,0,1,9,36750000
1327,Lekki,graceville court opposite ikate behind romay garden ilasan lekki lagos,2,2,1,1,1,0,0,0,0,4,4200000
1328,Lekki,ikate ikate lekki lagos,2,9,5,4,5,1,0,1,1,9,47250000
1329,Lekki,off freedom road lekki phase 1 lekki phase 1 lekki lagos,2,3,2,1,2,0,0,0,0,6,9450000
1330,Lekki,spg ologolo lekki lagos,2,2,1,1,1,0,0,0,1,4,11550000
1331,Lekki,cluster one estate ikota lekki lagos,2,7,4,3,4,0,0,0,0,7,21000000
1332,Lekki,off fola osibo street lekki lekki lagos,2,2,1,1,1,1,1,1,1,4,13650000
1333,Lekki,atlantic view estate igbo efon lekki lagos,2,9,5,4,5,0,0,0,1,9,36750000
1334,Lekki,osapa osapa london lekki lagos,2,9,5,4,5,1,1,1,1,9,58800000
1335,Lekki,providence street lekki phase 1 lekki lagos,2,2,1,1,1,1,1,1,1,4,13650000
1336,Lekki,ocean breeze estate ologolo lekki lagos,2,7,4,3,4,0,0,0,1,7,28350000
1337,Lekki,megamound ikota lekki lagos,2,7,4,3,4,0,0,0,1,7,26250000
1338,Lekki,off admiralty road lekki phase 1 lekki lagos,2,2,1,1,1,1,1,1,1,4,14700000
1339,Lekki,agungi lekki lagos,2,7,4,3,4,0,0,0,0,7,21000000
1340,Lekki,lekki phase 1 lekki phase 1 lekki lagos,2,7,4,3,4,1,1,1,1,7,45150000
1341,Lekki,canal west estate osapa london lekki lagos,2,11,6,5,6,0,0,0,0,10,49350000
1342,Lekki,lovely estate @chevron alternative chevron lekki lagos,2,9,5,4,5,0,0,0,1,9,36750000
1343,Lekki,leon garden chevron lekki lagos,2,9,5,4,5,0,0,0,1,9,36750000
1344,Lekki,off orchid road lekki ikota lekki lagos,2,2,1,1,1,0,0,0,0,4,4200000
1345,Lekki,elf lekki phase 1 lekki lagos,2,5,3,2,3,0,0,0,1,7,23100000
1346,Lekki,off alpha beach road igbo efon lekki lagos,2,4,2,2,2,0,0,0,0,6,9450000
1347,Lekki,lekki phase1 lekki phase 1 lekki lagos,2,9,5,4,5,1,1,1,1,9,58800000
1348,Lekki,off alpha beach road igbo efon lekki lagos,2,7,4,3,4,0,0,0,0,7,21000000
1349,Lekki,westend estate ikota lekki lagos,2,7,4,3,4,0,0,0,0,7,21000000
1350,Lekki,maruwa lekki phase 1 lekki lagos,2,9,5,4,5,0,0,0,1,9,39900000
1351,Lekki,chevron dirve chevron lekki lagos,2,9,5,4,5,0,0,0,1,9,36750000
1352,Lekki,villa estate ikota lekki lagos,2,9,5,4,5,0,0,0,1,9,36750000
1353,Lekki,pinnock beach estate lekki lagos,2,11,6,5,6,1,1,0,1,10,65100000
1354,Lekki,lekki county road ikota lekki lagos,2,9,5,4,5,0,0,0,1,9,36750000
1355,Lekki,west end estate ikota lekki lagos,2,7,4,3,4,0,0,0,0,7,21000000
1356,Lekki,agungi lekki lagos,2,7,4,3,4,0,0,0,0,7,21000000
1357,Lekki,orchid road chevron lekki lagos,2,9,5,4,5,0,0,0,1,9,36750000
1358,Lekki,alexander court osapa london lekki lagos,2,7,4,3,4,0,0,0,1,7,26250000
1359,Lekki,lekki phase1 lekki phase 1 lekki lagos,2,11,6,5,6,1,1,0,1,10,65100000
1360,Lekki,safecourt estate badore ajah lagos,2,7,4,3,4,1,0,0,1,7,31500000
1361,Lekki,maruwa lekki phase 1 lekki lagos,2,7,4,3,4,0,0,0,0,7,23100000
1362,Lekki,lekki phase 1 lekki lagos,2,9,5,4,5,1,1,1,1,9,58800000
1363,Lekki,oba amunsa estate agungi lekki lagos,2,12,6,6,6,0,0,0,0,10,49350000
1364,Lekki,chevy view chevron lekki lagos,2,7,4,3,4,0,0,0,0,7,21000000
1365,Lekki,allan balogun estate. agungi lekki lagos,2,2,1,1,1,0,0,0,0,4,5775000
1366,Lekki,ikate lekki lagos,2,5,3,2,3,0,0,0,1,7,21000000
1367,Lekki," peninsula estate, orchid chevron lekki lagos",2,12,7,5,7,1,1,0,1,10,71400000
1368,Lekki,ocean breeze estate ologolo lekki lagos,2,9,5,4,5,0,0,0,1,9,36750000
1369,Lekki,oral estate chevron lekki lagos,2,2,1,1,1,0,0,0,0,4,4200000
1370,Lekki,off fola osibo lekki phase 1 lekki lagos,2,7,4,3,4,1,1,1,1,7,45150000
1371,Lekki,bera estate chevron lekki lagos,2,9,5,4,5,1,0,0,1,9,42000000
1372,Lekki,eleganzer garden vgc lekki lagos,2,11,6,5,6,0,0,0,0,10,49350000
1373,Lekki,"orchid road, 2nd toll gate, lekki, lagos lekki phase 2 lekki lagos",2,9,5,4,5,1,0,0,1,9,42000000
1374,Lekki,gated community ikate lekki lagos,2,11,6,5,6,0,0,0,1,10,57750000
1375,Lekki,gated community ikate lekki lagos,2,11,6,5,6,0,0,0,1,10,63000000
1376,Lekki,ologolo lekki lagos,2,11,6,5,6,1,1,0,1,10,65100000
1377,Lekki,lekki county road ikota lekki lagos,2,9,5,4,5,0,0,0,1,9,36750000
1378,Lekki,megamound ikota lekki lagos,2,9,5,4,5,0,0,0,1,9,36750000
1379,Lekki,off road 14 lekki phase 1 lekki lagos,2,12,7,5,7,1,1,0,1,10,71400000
1380,Lekki,- ilasan lekki lagos,2,7,4,3,4,0,0,0,0,7,21000000
1381,Lekki,bera estate chevron lekki lagos,2,9,5,4,5,0,0,0,1,9,36750000
1382,Lekki,lekki scheme 2 ogombo ajah lagos,2,9,5,4,5,0,0,0,1,9,36750000
1383,Lekki,road 14 lekki phase 1 lekki lagos,2,11,6,5,6,1,1,0,1,10,65100000
1384,Lekki,eleganzer garden vgc lekki lagos,2,11,6,5,6,0,0,0,0,10,49350000
1385,Lekki,atlantic view estate igbo efon lekki lagos,2,2,1,1,1,0,0,0,0,4,4200000
1386,Lekki,chief collins street. lekki phase 1 lekki lagos,2,2,1,1,1,0,0,0,1,4,8400000
1387,Lekki,awkulu street off providence street lekki phase 1 lekki phase 1 lekki lagos,2,3,2,1,2,0,0,0,0,6,11550000
1388,Lekki,ikate lekki lagos,2,9,5,4,5,0,0,0,1,9,36750000
1389,Lekki,oba amunsan estate idado lekki lagos,2,11,6,5,6,0,0,0,0,10,49350000
1390,Lekki,osapa london osapa london lekki lagos,2,3,2,1,2,0,0,0,0,6,10500000
1391,Lekki,- ilasan lekki lagos,2,9,5,4,5,0,0,0,1,9,36750000
1392,Lekki,gated estate @ologolo ologolo lekki lagos,2,9,5,4,5,0,0,0,1,9,36750000
1393,Lekki,road16 ikota lekki lagos,2,3,2,1,2,0,0,0,0,6,9450000
1394,Lekki,ikota villa ikota lekki lagos,2,9,5,4,5,0,0,0,1,9,36750000
1395,Lekki,megamound ikota lekki lagos,2,11,6,5,6,0,0,0,0,10,49350000
1396,Lekki,ikate ikate lekki lagos,2,7,4,3,4,1,1,1,1,7,36750000
1397,Lekki," napier garden estate, beside manor garden, ikota, lekki, lagos ikota lekki lagos",2,9,5,4,5,0,0,0,1,9,39900000
1398,Lekki,kensular ikate lekki lagos,2,9,5,4,5,0,0,0,1,9,36750000
1399,Lekki,osapa london osapa london lekki lagos,2,9,5,4,5,1,0,0,1,9,42000000
1400,Lekki," lafiaji, lekki lagos",2,9,5,4,5,0,0,0,1,9,39900000
1401,Lekki,oral estate chevron lekki lagos,2,7,4,3,4,0,0,0,0,7,21000000
1402,Lekki,chevron axis lekki lagos,2,7,4,3,4,0,0,0,0,7,23100000
1403,Lekki,off kensular ikate lekki lagos,2,7,4,3,4,0,0,0,0,7,23100000
1404,Lekki,"tam ogboi street,off freedom way lekki phase 1 lekki phase 1 lekki lagos",2,7,4,3,4,1,0,0,1,7,31500000
1405,Lekki,lekki phase1 lekki phase 1 lekki lagos,2,7,4,3,4,1,1,1,1,7,45150000
1406,Lekki,off admiralty road lekki phase 1 lekki lagos,2,2,1,1,1,1,0,0,1,4,12600000
1407,Lekki,ikate lekki lagos,2,11,6,5,6,0,0,0,0,10,49350000
1408,Lekki,the address estate osapa london lekki lagos,2,9,5,4,5,1,1,1,1,9,57750000
1409,Lekki,eleganzer garden vgc lekki lagos,2,9,5,4,5,0,0,0,1,9,36750000
1410,Lekki,gated estate lekki phase 1 lekki lagos,2,11,6,5,6,1,1,0,1,10,65100000
1411,Lekki,igbo efon lekki lagos,2,5,3,2,3,0,0,0,0,7,10500000
1412,Lekki,oral estate oral estate lekki lagos,2,2,1,1,1,0,0,0,0,4,5775000
1413,Lekki,kusenla ikate lekki lagos,2,9,4,5,4,1,1,1,1,7,45150000
1414,Lekki,lekki right lekki phase 1 lekki lagos,2,9,5,4,5,1,1,1,1,9,54600000
1415,Lekki,ikate lekki lagos,2,3,2,1,2,0,0,0,0,6,9450000
1416,Lekki,primewaterview estate lekki phase 1 lekki lagos,2,10,5,5,5,0,0,0,1,9,36750000
1417,Lekki,free trade zone ibeju lekki lagos,2,12,6,6,6,0,0,0,0,10,49350000
1418,Lekki,lekki phase 2 lekki lagos,2,10,5,5,5,0,0,0,1,9,36750000
1419,Lekki,lekki phase 1 lekki lagos,2,8,4,4,4,1,1,1,1,7,45150000
1420,Lekki,ikota lekki lagos,2,7,4,3,4,0,0,0,0,7,23100000
1421,Lekki,ikota lekki lagos,2,9,5,4,5,0,0,0,1,9,36750000
1422,Lekki,- chevron lekki lagos,2,9,5,4,5,0,0,0,1,9,36750000
1423,Lekki,opposite mega chicken ikota ikota lekki lagos,2,10,5,5,5,0,0,0,1,9,36750000
1424,Lekki,chevron lekki lagos,2,9,5,4,5,0,0,0,1,9,36750000
1425,Lekki,lekki phase 1 lekki lagos,2,11,6,5,6,1,1,0,1,10,65100000
1426,Lekki,jakande jakande lekki lagos,2,5,3,2,3,0,0,0,1,7,21000000
1427,Lekki,lekki lagos,2,10,5,5,5,0,0,0,1,9,36750000
1428,Lekki,lekki lekki phase 1 lekki lagos,2,9,5,4,5,0,0,0,1,9,36750000
1429,Lekki,osapa london lekki lagos,2,9,5,4,5,0,0,0,1,9,36750000
1430,Lekki,ikate lekki lagos,2,9,5,4,5,1,1,1,1,9,58800000
1431,Lekki,lekki phase 1 lekki lagos,2,8,4,4,4,1,1,1,1,7,36750000
1432,Lekki,arcadia groove estate osapa london lekki lagos,2,11,6,5,6,1,1,0,1,10,65100000
1433,Lekki,osapa osapa london lekki lagos,2,5,3,2,3,0,0,0,1,7,21000000
1434,Lekki,- lekki phase 1 lekki lagos,2,9,5,4,5,0,0,0,1,9,36750000
1435,Lekki,lekki phase 1 lekki lagos,2,8,4,4,4,1,0,0,1,7,31500000
1436,Lekki,chevron lekki lagos,2,10,5,5,5,0,0,0,1,9,36750000
1437,Lekki,lekki phase 1 lekki lagos,2,5,3,2,3,1,1,1,1,7,36750000
1438,Lekki,lekki phase 1 lekki lagos,2,8,4,4,4,1,1,1,1,7,36750000
1439,Lekki,ikota villa ikota lekki lagos,2,7,4,3,4,0,0,0,0,7,21000000
1440,Lekki,mobolaji johnson estate lekki phase 1 lekki lagos,2,9,5,4,5,0,0,0,1,9,36750000
1441,Lekki,chevron drive chevron lekki lagos,2,9,5,4,5,0,0,0,1,9,36750000
1442,Lekki,ologolo lekki lagos,2,10,5,5,5,0,0,0,1,9,36750000
1443,Lekki,lekki lekki phase 1 lekki lagos,2,7,4,3,4,1,1,1,1,7,45150000
1444,Lekki,chevron lekki lagos,2,11,6,5,6,0,0,0,0,10,49350000
1445,Lekki,chevron lekki lagos,2,7,4,3,4,0,0,0,0,7,21000000
1446,Lekki,osapa osapa london lekki lagos,2,3,1,2,1,1,1,1,1,4,21000000
1447,Lekki,off freedom way ikate lekki lagos,2,2,1,1,1,0,0,0,0,4,7350000
1448,Lekki,chevron lekki lagos,2,10,5,5,5,0,0,0,1,9,36750000
1449,Lekki,chevron lekki lagos,2,9,5,4,5,0,0,0,1,9,36750000
1450,Lekki,osapa london lekki lagos,2,7,4,3,4,0,0,0,0,7,21000000
1451,Lekki,megamounds estates ikota lekki lagos,2,11,6,5,6,0,0,0,0,10,52500000
1452,Lekki,lekki phase 1 lekki lagos,2,9,5,4,5,1,0,0,1,9,42000000
1453,Lekki,chevron lekki lagos,2,8,4,4,4,0,0,0,0,7,21000000
1454,Lekki,lekki phase 1 lekki lagos,2,7,4,3,4,1,1,1,1,7,42000000
1455,Lekki,lekki phase 1 lekki lagos,2,10,5,5,5,0,0,0,1,9,39900000
1456,Lekki,lekki phase 1 lekki lagos,2,5,3,2,3,1,1,0,1,7,26250000
1457,Lekki,ikota lekki lagos,2,7,4,3,4,0,0,0,1,7,26250000
1458,Lekki,chevron lekki lagos,2,12,6,6,6,0,0,0,0,10,49350000
1459,Lekki,chevron drive chevron lekki lagos,2,7,4,3,4,0,0,0,1,7,26250000
1460,Lekki,lekki lekki phase 1 lekki lagos,2,13,7,6,7,0,0,0,1,10,63000000
1461,Lekki,lekki phase 1 lekki lagos,2,9,5,4,5,1,1,1,1,9,58800000
1462,Lekki,ikota villa estates ikota lekki lagos,2,9,5,4,5,0,0,0,1,9,36750000
1463,Lekki,pinnock estate jakande lekki lagos,2,13,7,6,7,0,0,0,1,10,68250000
1464,Lekki,ikate ikate lekki lagos,2,7,4,3,4,1,0,0,1,7,31500000
1465,Lekki,osapa london lekki lagos,2,9,5,4,5,0,0,0,1,9,36750000
1466,Lekki,located in lekki county homes ikota lekki lagos nigeria ikota lekki lagos,2,11,6,5,6,1,1,0,1,10,65100000
1467,Lekki,osapa london lekki lagos,2,10,5,5,5,0,0,0,1,9,36750000
1468,Lekki,"admiralty way,lekki phase one lekki phase 1 lekki lagos",2,5,3,2,3,1,1,1,1,7,36750000
1469,Lekki,lekki phase 1 lekki lagos,2,13,7,6,7,0,0,0,1,10,63000000
1470,Lekki,chevron lekki lagos,2,10,5,5,5,0,0,0,1,9,36750000
1471,Lekki,osapa osapa london lekki lagos,2,5,3,2,3,0,0,0,1,7,21000000
1472,Lekki,osapa osapa london lekki lagos,2,5,3,2,3,0,0,0,1,7,21000000
1473,Lekki,chevron lekki lagos,2,11,6,5,6,0,0,0,0,10,49350000
1474,Lekki,lekki phase 1 lekki lagos,2,7,4,3,4,0,0,0,1,7,29400000
1475,Lekki,chevron lekki lagos,2,8,4,4,4,0,0,0,0,7,21000000
1476,Lekki,chevron drive chevron lekki lagos,2,9,5,4,5,0,0,0,1,9,36750000
1477,Lekki,lekki county estate ikota lekki lagos,2,6,3,3,3,0,0,0,0,7,16800000
1478,Lekki,lekki phase 1 lekki lagos,2,13,7,6,7,0,0,0,0,10,57750000
1479,Lekki,ikate lekki lagos,2,8,4,4,4,0,0,0,1,7,28350000
1480,Lekki,lekki phase 1 lekki lagos,2,7,4,3,4,1,1,1,1,7,45150000
1481,Lekki,chevron chevron lekki lagos,2,9,5,4,5,0,0,0,1,9,36750000
1482,Lekki,chevron alternative route lekki phase 1 lekki lagos,2,11,6,5,6,1,1,0,1,10,65100000
1483,Lekki,ikota ikota lekki lagos,2,9,5,4,5,1,0,0,1,9,42000000
1484,Lekki,chevron lekki lagos,2,10,5,5,5,0,0,0,1,9,36750000
1485,Lekki,orchid road ikota lekki lagos,2,9,5,4,5,0,0,0,1,9,36750000
1486,Lekki,chevron lekki lagos,2,12,6,6,6,0,0,0,0,10,49350000
1487,Lekki,marwa lekki phase 1 lekki lagos,2,9,5,4,5,1,0,1,1,9,47250000
1488,Lekki,lekki phase 1 lekki lagos,2,7,4,3,4,1,1,1,1,7,45150000
1489,Lekki,lekki phase 1 lekki lagos,2,11,6,5,6,0,0,0,1,10,63000000
1490,Lekki,chevron drive chevron lekki lagos,2,7,4,3,4,0,0,0,0,7,24150000
1491,Lekki,idado lekki lagos,2,9,5,4,5,0,0,0,1,9,36750000
1492,Lekki,eputu ibeju lekki lagos,2,2,1,1,1,0,0,0,0,4,4777500
1493,Lekki,beside prime waters ikate lekki lagos,2,2,1,1,1,0,0,0,1,4,8557500
1494,Lekki,located at west end estate off lekki county estate ikota lekki lagos,2,9,5,4,5,0,0,0,1,9,36750000
1495,Lekki,safe court apartments lekki phase 1 lekki lagos,2,7,4,3,4,1,0,0,1,7,31500000
1496,Lekki,lekki phase 1 lekki lagos,2,10,5,5,5,1,1,1,1,9,52500000
1497,Lekki,femi okunu estate lekki phase 1 lekki lagos,2,10,5,5,5,0,0,0,1,9,36750000
1498,Lekki,lekki phase 1 lekki lagos,2,7,4,3,4,1,1,1,1,7,36750000
1499,Lekki,lekki phase 1 lekki lagos,2,4,2,2,2,0,0,0,1,6,15750000
1500,Lekki,lekki phase 1 lekki lagos,2,6,3,3,3,0,0,0,1,7,21000000
1501,Lekki,lekki phase 1 lekki phase 1 lekki lagos,2,12,6,6,6,1,1,0,1,10,65100000
1502,Lekki,idado lekki lagos,2,9,5,4,5,1,0,0,1,9,42000000
1503,Lekki,lekki lagos,2,4,2,2,2,0,0,0,0,6,9450000
1504,Lekki,lekki lagos,2,4,2,2,2,0,0,0,0,6,9450000
1505,Lekki,located at chisco at ikate lekki inside an estate ikate lekki lagos,2,7,4,3,4,1,1,1,1,7,36750000
1506,Lekki,osapa london lekki lagos,2,8,4,4,4,0,0,0,0,7,23100000
1507,Lekki,lekki lagos,2,6,3,3,3,1,1,1,1,7,31500000
1508,Lekki,lekki lagos,2,16,8,8,8,1,1,0,1,10,73500000
1509,Lekki,lekki lagos,2,10,5,5,5,1,1,1,1,9,58800000
1510,Lekki,"ikota villa, behind mega chicken, lekki phase 2 lekki lagos",2,9,5,4,5,0,0,0,1,9,36750000
1511,Lekki," chevron, lekki, lagos chevron lekki lagos",2,8,4,4,4,0,0,0,0,7,21000000
1512,Lekki," chevron, lekki lagos chevron lekki lagos",2,9,4,5,4,0,0,0,0,7,21000000
1513,Lekki,value county estate near lagos business school off lekki epe expressway ajah lagos,2,8,4,4,4,0,0,0,0,7,21000000
1514,Lekki,lekki lagos,2,10,5,5,5,1,0,0,1,9,42000000
1515,Lekki,agungi lekki lagos,2,8,4,4,4,1,1,1,1,7,42000000
1516,Lekki,ologolo lekki lagos,2,7,4,3,4,0,0,0,1,7,26250000
1517,Lekki,osapa london lekki lagos,2,2,1,1,1,0,0,0,0,4,6300000
1518,Lekki,after lbs in olokonla in ajah axis lekki. olokonla ajah lagos,2,7,4,3,4,0,0,0,0,7,21000000
1519,Lekki,opp ikota villa before ajah in lekki. lekki phase 2 lekki lagos,2,4,2,2,2,0,0,0,0,6,9450000
1520,Lekki,osapa london lekki lagos,2,6,3,3,3,0,0,0,0,7,12600000
1521,Lekki,lekki phase 1 lekki lagos,2,7,4,3,4,0,0,0,0,7,21000000
1522,Lekki,lekki phase 1 lekki lagos,2,2,1,1,1,0,0,0,0,4,7350000
1523,Lekki,chevron lekki lagos,2,6,3,3,3,0,0,0,1,7,21000000
1524,Lekki,lekki phase 1 lekki phase 1 lekki lagos,2,2,1,1,1,0,0,0,1,4,10500000
1525,Lekki,igbo efon igbo efon lekki lagos,2,2,1,1,1,0,0,0,0,4,4725000
1526,Lekki,lekki lagos,2,8,4,4,4,1,0,0,1,7,31500000
1527,Lekki,lekki lagos,2,6,3,3,3,1,1,0,1,7,26250000
1528,Lekki,ikota lekki lagos,2,2,1,1,1,0,0,0,0,4,4200000
1529,Lekki,lekki lagos,2,8,4,4,4,1,0,0,1,7,31500000
1530,Lekki,lekki lagos,2,8,4,4,4,1,1,1,1,7,36750000
1531,Lekki,lekki lagos,2,8,4,4,4,1,1,1,1,7,45150000
1532,Lekki,lekki phase 1 lekki lagos,2,3,2,1,2,0,0,0,0,6,12600000
1533,Lekki,lekki lagos,2,8,4,4,4,1,1,1,1,7,36750000
1534,Lekki,lekki lagos,2,8,4,4,4,1,0,0,1,7,31500000
1535,Lekki,lekki lagos,2,6,3,3,3,0,0,0,0,7,10500000
1536,Lekki,osapa london osapa london lekki lagos,2,2,1,1,1,0,0,0,0,4,5250000
1537,Lekki,around blenco supermarket before sangotedo in ajah axis lekki. peninsula estate ajah lagos,2,3,2,1,2,0,0,0,0,6,9450000
1538,Lekki,after blenco supermarket before sangotedo market in ajah axis lekki. sangotedo ajah lagos,2,7,4,3,4,0,0,0,0,7,21000000
1539,Lekki,fidiso estate in kingdom hall road in abijo in ajah axis lekki. abijo ajah lagos,2,2,1,1,1,0,0,0,0,4,4200000
1540,Lekki,after blenco supermarket before sangotedo market in ajah axis lekki. sangotedo ajah lagos,2,9,5,4,5,0,0,0,1,9,36750000
1541,Lekki,majek sangotedo in ajah axis lekki. sangotedo ajah lagos,2,3,2,1,2,0,0,0,0,6,9450000
1542,Lekki,opp sangotedo market in ajah axis lekki. sangotedo ajah lagos,2,5,3,2,3,0,0,0,0,7,10500000
1543,Lekki,opp sangotedo market in ajah axis lekki. sangotedo ajah lagos,2,7,4,3,4,0,0,0,0,7,21000000
1544,Lekki,orchid hotel road lekki phase 2 lekki lagos,2,10,5,5,5,1,0,0,1,9,42000000
1545,Lekki,orchid hotel road. lekki phase 2 lekki lagos,2,10,5,5,5,0,0,0,1,9,36750000
1546,Lekki,18 ihuntayi street off palace road oniru estate lekki phase 1 lekki lagos,2,6,3,3,3,1,1,1,1,7,31500000
1547,Lekki,bera estate chevron lekki lagos,2,10,5,5,5,1,1,1,1,9,52500000
1548,Lekki,lekki lagos,2,4,2,2,2,1,1,1,1,6,21000000
1549,Lekki,innocent street igbo efon igbo efon lekki lagos,2,2,1,1,1,0,0,0,0,4,4725000
1550,Lekki,igbo efon igbo efon lekki lagos,2,2,1,1,1,0,0,0,0,4,4200000
1551,Lekki,abraham adesanya estate ajah lagos,2,4,2,2,2,0,0,0,0,6,9450000
1552,Lekki,villa estate ikota lekki lagos,2,6,3,3,3,0,0,0,1,7,21000000
1553,Lekki,lekki garden estate phase 4 lekki gardens estate ajah lagos,2,9,5,4,5,0,0,0,1,9,36750000
1554,Lekki," megamound estate by lekki county estate, ikota lekki lagos",2,11,6,5,6,0,0,0,0,10,49350000
1555,Lekki,behind the new shoprite in sangotedo in ajah axis lekki. sangotedo ajah lagos,2,10,5,5,5,0,0,0,1,9,36750000
1556,Lekki,lekki phase 1 lekki phase 1 lekki lagos,2,10,5,5,5,1,1,1,1,9,58800000
1557,Lekki,idado estate idado lekki lagos,2,7,4,3,4,0,0,0,1,7,26250000
1558,Lekki," behind cooplag garden, on orchid road ikota lekki lagos",2,6,3,3,3,0,0,0,0,7,10500000
1559,Lekki,beside french colony estate off agungi - ajiran road lekki agungi lekki lagos,2,5,3,2,3,0,0,0,1,7,21000000
1560,Lekki,ik ikate lekki lagos,2,8,4,4,4,1,1,1,1,7,36750000
1561,Lekki,ikate elegushi ikate lekki lagos,2,9,5,4,5,0,0,0,1,9,36750000
1562,Lekki,jakande 1st gate jakande lekki lagos,2,7,4,3,4,0,0,0,1,7,26250000
1563,Lekki,behind nigel office lekki phase 1 lekki lagos,2,10,5,5,5,1,1,1,1,9,52500000
1564,Lekki," ikate elegushi, ikate lekki lagos",2,8,4,4,4,0,0,0,0,7,21000000
1565,Lekki,ikate lekki lagos,2,6,3,3,3,0,0,0,1,7,23100000
1566,Lekki,chevy view estate chevron lekki lagos,2,7,4,3,4,0,0,0,0,7,21000000
1567,Lekki,"bera estate, chevron. lekki phase 1 lekki lagos",2,9,5,4,5,0,0,0,1,9,36750000
1568,Lekki,ikate lekki lagos,2,10,5,5,5,1,1,1,1,9,58800000
1569,Lekki,lekki palm city estate off lekki epe expressway ajah lagos,2,7,4,3,4,0,0,0,0,7,21000000
1570,Lekki,freedom way lekki phase 1 ikoyi lagos,2,10,5,5,5,1,1,1,1,9,58800000
1571,Lekki," ikate lekki lagos, ikate lekki lagos",2,8,4,4,4,1,1,1,1,7,45150000
1572,Lekki,ologolo ologolo lekki lagos,2,5,3,2,3,0,0,0,0,7,17850000
1573,Lekki,lekki lagos,2,2,1,1,1,1,1,1,1,4,16800000
1574,Lekki,ikate lekki lagos ikate lekki lagos,2,9,5,4,5,0,0,0,1,9,36750000
1575,Lekki,kusenla road ikate lekki lagos,2,7,4,3,4,1,0,0,1,7,31500000
1576,Lekki,lekki lagos,2,2,1,1,1,1,1,1,1,4,13650000
1577,Lekki,lekki phase1 lekki phase 1 lekki lagos,2,7,4,3,4,0,0,0,1,7,26250000
1578,Lekki,ikota villa estate ikota lekki lagos,2,7,4,3,4,0,0,0,0,7,21000000
1579,Lekki,"off babatunde anjouse street, lekki phase 1 lekki lagos",2,5,3,2,3,1,1,0,1,7,26250000
1580,Lekki,lekki phase1 lekki phase 1 lekki lagos,2,5,3,2,3,1,1,1,1,7,36750000
1581,Lekki,oral estate lekki lagos,2,8,4,4,4,1,1,1,1,7,45150000
1582,Lekki,ikate lekki lagos,2,5,3,2,3,0,0,0,1,7,21000000
1583,Lekki," ikate elegushi, ikate lekki lagos",2,7,4,3,4,0,0,0,0,7,21000000
1584,Lekki,lekki phase1 lekki phase 1 lekki lagos,2,7,4,3,4,1,1,1,1,7,45150000
1585,Lekki," ogunfayo mini estate awoyaya, awoyaya ibeju lekki lagos",2,10,5,5,5,0,0,0,1,9,36750000
1586,Lekki,jakande lekki lagos,2,8,4,4,4,1,1,1,1,7,39900000
1587,Lekki,lekki lagos,2,8,4,4,4,0,0,0,1,7,28350000
1588,Lekki,osapa london lekki lagos,2,9,5,4,5,1,1,1,1,9,52500000
1589,Lekki,osapa osapa london lekki lagos,2,9,5,4,5,0,0,0,1,9,37800000
1590,Lekki,chevron lekki lagos,2,8,4,4,4,1,1,1,1,7,36750000
1591,Lekki,chevron lekki lagos,2,8,4,4,4,1,1,1,1,7,36750000
1592,Lekki,osapa osapa london lekki lagos,2,10,5,5,5,0,0,0,1,9,36750000
1593,Lekki,chevron lekki lagos,2,9,5,4,5,0,0,0,1,9,36750000
1594,Lekki," ikota villa estate, ikota lekki lagos",2,11,5,6,5,1,1,1,1,9,58800000
1595,Lekki,lekki phase 1 lekki lagos,2,10,5,5,5,1,1,1,1,9,58800000
1596,Lekki,ikota villa gra ikota lekki lagos,2,5,3,2,3,0,0,0,0,7,15750000
1597,Lekki,majek opp fara park after crown estate in sangotedo in ajah axis lekki. crown estate ajah lagos,2,8,4,4,4,0,0,0,0,7,21000000
1598,Lekki,bera chevron lekki lagos,2,8,4,4,4,0,0,0,0,7,21000000
1599,Lekki,dr alakija lekki phase 1 lekki lagos,2,8,4,4,4,1,0,0,1,7,31500000
1600,Lekki,alternative route chevron lekki lagos,2,9,5,4,5,0,0,0,1,9,36750000
1601,Lekki,ologolo ologolo lekki lagos,2,3,2,1,2,0,0,0,0,6,10500000
1602,Lekki,ikate lekki lagos,2,9,5,4,5,1,0,1,1,9,47250000
1603,Lekki,bera estate chevron lekki lagos,2,7,4,3,4,0,0,0,0,7,21000000
1604,Lekki,lekki palms estate lavalon hotel estate off addo road ajah ado ajah lagos,2,9,5,4,5,0,0,0,1,9,36750000
1605,Lekki,lekki lagos,2,4,2,2,2,1,1,1,1,6,21000000
1606,Lekki,agungi road lekki lagos,2,2,1,1,1,0,0,0,1,4,8400000
1607,Lekki,southern view estate beside lekki conservation center opp chevron lekki peninsula lekki chevron lekki lagos,2,2,1,1,1,0,0,0,1,4,9450000
1608,Lekki,chevy view lekki lagos,2,11,6,5,6,0,0,0,0,10,49350000
1609,Lekki,chevron drive chevron lekki lagos,2,7,4,3,4,0,0,0,0,7,25200000
1610,Lekki,lekki lagos,2,10,5,5,5,1,1,1,1,9,58800000
1611,Lekki,salem lekki phase 1 lekki lagos,2,7,4,3,4,0,0,0,0,7,21000000
1612,Lekki,off castle and temple off admiralty road lekki phase 1 lekki lagos,2,7,4,3,4,1,1,1,1,7,45150000
1613,Lekki,off road 14 lekki phase 1 lekki lagos,2,7,4,3,4,1,0,0,1,7,31500000
1614,Lekki,ikate lekki lagos,2,10,5,5,5,1,1,1,1,9,58800000
1615,Lekki,chevron lekki lagos,2,8,4,4,4,1,1,1,1,7,36750000
1616,Lekki,lekki lagos,2,4,2,2,2,1,1,1,1,6,21000000
1617,Lekki," around crown estate, sangotedo, ajah axis, lekki. sangotedo ajah lagos",2,6,3,3,3,0,0,0,0,7,10500000
1618,Lekki," not far from pinnock beach estate, jakande, lekki osapa london lekki lagos",2,6,3,3,3,1,1,0,1,7,26250000
1619,Lekki,oral estate lekki lagos,2,10,5,5,5,1,0,1,1,9,47250000
1620,Lekki,estate osapa london lekki lagos,2,2,1,1,1,0,0,0,1,4,8925000
1621,Lekki,osapa osapa london lekki lagos,2,2,1,1,1,1,0,0,1,4,12600000
1622,Lekki,ikate elegushi ikate lekki lagos,2,5,3,2,3,0,0,0,1,7,21000000
1623,Lekki,lekki phase 2 lekki phase 2 lekki lagos,2,9,5,4,5,0,0,0,1,9,36750000
1624,Lekki,chevy view estate chevron lekki lagos,2,11,6,5,6,0,0,0,0,10,52500000
1625,Lekki,lekki paradise estate chevron lekki lagos,2,9,5,4,5,1,1,1,1,9,52500000
1626,Lekki,osapa london lekki lagos,2,12,6,6,6,1,1,0,1,10,65100000
1627,Lekki," ikate elegushi, ikate lekki lagos",2,6,3,3,3,1,1,1,1,7,31500000
1628,Lekki,ikate lekki lagos ikate lekki lagos,2,5,3,2,3,1,1,0,1,7,26250000
1629,Lekki,osapa osapa london lekki lagos,2,2,1,1,1,0,0,0,0,4,6300000
1630,Lekki,lekki phase 1 lekki lagos,2,10,5,5,5,1,1,1,1,9,58800000
1631,Lekki,chevron lekki lagos,2,9,5,4,5,1,0,1,1,9,47250000
1632,Lekki,"off freedom way, lekki phase 1 lekki phase 1 lekki lagos",2,3,2,1,2,0,0,0,0,6,14700000
1633,Lekki,ikota villa estate ikota lekki lagos,2,7,4,3,4,0,0,0,0,7,21000000
1634,Lekki,5 street estate osapa london lekki lagos,2,2,1,1,1,0,0,0,0,4,4200000
1635,Lekki,osapa london osapa london lekki lagos,2,5,3,2,3,0,0,0,0,7,18900000
1636,Lekki,agungi agungi lekki lagos,2,7,4,3,4,0,0,0,1,7,26250000
1637,Lekki,chevy view estate chevron lekki lagos,2,7,4,3,4,0,0,0,0,7,23100000
1638,Lekki,igbo efon by eti osa lg igbo efon lekki lagos,2,5,3,2,3,0,0,0,0,7,10500000
1639,Lekki,lekki lagos,2,8,4,4,4,1,1,1,1,7,36750000
1640,Lekki,osapa london osapa london lekki lagos,2,2,1,1,1,0,0,0,1,4,11550000
1641,Lekki,lekki ph1 estate lagos. lekki phase 1 lekki lagos,2,7,4,3,4,1,1,1,1,7,45150000
1642,Lekki,osapa london lekki lagos,2,6,3,3,3,0,0,0,1,7,21000000
1643,Lekki,oceanestate ologolo lekki lagos,2,8,4,4,4,0,0,0,0,7,21000000
1644,Lekki,ocean breeze ologolo lekki lagos,2,10,5,5,5,0,0,0,1,9,36750000
1645,Lekki,agungi agungi lekki lagos,2,3,1,2,1,1,1,1,1,4,21000000
1646,Lekki,lekki lagos,2,2,1,1,1,1,1,1,1,4,16800000
1647,Lekki,before blenco supermarket in olokonla in ajah axis lekki. olokonla ajah lagos,2,10,5,5,5,0,0,0,1,9,36750000
1648,Lekki," ikate elegushi, lekki lagos",2,2,1,1,1,0,0,0,0,4,5250000
1649,Lekki,before sangotedo market in sangotedo in ajah axis lekki. sangotedo ajah lagos,2,6,3,3,3,0,0,0,0,7,10500000
1650,Lekki,off kusenla ikate lekki lagos,2,9,5,4,5,0,0,0,1,9,36750000
1651,Lekki,off admiralty road lekki phase 1 lekki lagos,2,8,4,4,4,1,1,1,1,7,45150000
1652,Lekki,by mobolaji johnson lekki phase 1 lekki lagos,2,7,4,3,4,1,1,1,1,7,36750000
1653,Lekki,around the new shoprite in sangotedo in ajah axis lekki. sangotedo ajah lagos,2,10,5,5,5,0,0,0,1,9,36750000
1654,Lekki,. ologolo lekki lagos,2,7,4,3,4,1,0,0,1,7,33600000
1655,Lekki,lekki phase 1 lekki lagos,2,2,1,1,1,1,1,1,1,4,15750000
1656,Lekki,close to the spar ikate lekki lagos,2,8,4,4,4,1,0,0,1,7,31500000
1657,Lekki,lekki right lekki phase 1 lekki lagos,2,7,4,3,4,1,1,1,1,7,39900000
1658,Lekki,ikota lekki lagos,2,8,4,4,4,1,0,0,1,7,31500000
1659,Lekki,ikota ikota lekki lagos,2,8,4,4,4,1,1,1,1,7,36750000
1660,Lekki,lekki phase 1 lekki lagos,2,8,5,3,5,0,0,0,1,9,36750000
1661,Lekki,"oladimeji alo street, lekki phase 1 lekki lagos",2,11,6,5,6,0,0,0,0,10,52500000
1662,Lekki,off kazim osapa london lekki lagos,2,6,3,3,3,0,0,0,1,7,21000000
1663,Lekki,- osapa london lekki lagos,2,2,1,1,1,0,0,0,0,4,5250000
1664,Lekki,lekki lekki phase 1 lekki lagos,2,8,4,4,4,0,0,0,1,7,26250000
1665,Lekki,lekki phase one lekki phase 1 lekki lagos,2,5,3,2,3,1,1,1,1,7,31500000
1666,Lekki,agungi lekki lagos,2,6,3,3,3,0,0,0,0,7,18900000
1667,Lekki," idado, lekki idado lekki lagos",2,5,3,2,3,0,0,0,0,7,15750000
1668,Lekki,fubara green igbo efon lekki lagos,2,4,2,2,2,0,0,0,0,6,12600000
1669,Lekki,ikate ikate lekki lagos,2,11,6,5,6,0,0,0,1,10,63000000
1670,Lekki," valley stream estate, osapa london lekki lagos",2,9,5,4,5,0,0,0,1,9,36750000
1671,Lekki,.. idado lekki lagos,2,2,1,1,1,0,0,0,1,4,10500000
1672,Lekki,lekki paradise chevron lekki lagos,2,8,4,4,4,1,0,0,1,7,31500000
1673,Lekki,agungi agungi lekki lagos,2,2,1,1,1,0,0,0,0,4,4725000
1674,Lekki," lekki palm city estate, off ado road, ajah, lagos. badore ajah lagos",2,9,5,4,5,0,0,0,1,9,36750000
1675,Lekki,off chevron drive chevron lekki lagos,2,7,4,3,4,1,0,0,1,7,31500000
1676,Lekki,chevron drive chevron lekki lagos,2,7,4,3,4,1,1,1,1,7,36750000
1677,Lekki,lekki phase 1 lekki lagos,2,6,3,3,3,1,1,1,1,7,31500000
1678,Lekki,lekki lagos,2,2,1,1,1,1,1,1,1,4,17850000
1679,Lekki,off admiralty road lekki phase 1 lekki lagos,2,9,5,4,5,1,1,1,1,9,58800000
1680,Lekki,agungi lekki lagos,2,6,3,3,3,0,0,0,0,7,18900000
1681,Lekki,osapa london lekki lagos,2,9,5,4,5,0,0,0,1,9,36750000
1682,Lekki,lafiaji road ikota lekki lagos,2,9,5,4,5,0,0,0,1,9,36750000
1683,Lekki,. lekki lagos,2,6,3,3,3,0,0,0,1,7,21000000
1684,Lekki,lekki county ikota lekki lagos,2,8,4,4,4,1,1,1,1,7,45150000
1685,Lekki,lekki phase 2 lekki phase 2 lekki lagos,2,9,5,4,5,0,0,0,1,9,36750000
1686,Lekki,osapa london lekki lagos,2,11,6,5,6,0,0,0,0,10,49350000
1687,Lekki," ikate elegushi, ikate lekki lagos",2,2,1,1,1,0,0,0,0,4,4200000
1688,Lekki,vgc lekki lagos,2,12,7,5,7,0,0,0,0,10,57750000
1689,Lekki,fola osibo. lekki phase 1 lekki lagos,2,13,7,6,7,1,1,0,1,10,71400000
1690,Lekki,fatai arobike lekki phase 1 lekki lagos,2,2,1,1,1,1,1,1,1,4,15750000
1691,Lekki,ikate lekki lagos,2,8,4,4,4,1,0,0,1,7,31500000
1692,Lekki,elegushi ikate lekki lagos,2,10,5,5,5,0,0,0,1,9,36750000
1693,Lekki,off admiralty road lekki phase 1 lekki lagos,2,9,5,4,5,1,1,1,1,9,58800000
1694,Lekki,lekki phase 1 lekki phase 1 lekki lagos,2,2,1,1,1,1,1,1,1,4,16800000
1695,Lekki,osapa osapa london lekki lagos,2,2,1,1,1,0,0,0,0,4,6300000
1696,Lekki," majek after fara park, after crown estate in ajah axis lekki. crown estate ajah lagos",2,6,3,3,3,0,0,0,0,7,10500000
1697,Lekki,lbs lekki phase 2 lekki lagos,2,8,4,4,4,0,0,0,0,7,21000000
1698,Lekki,ikate lekki lagos,2,7,4,3,4,0,0,0,0,7,24150000
1699,Lekki,lekki lagos,2,4,2,2,2,1,1,1,1,6,21000000
1700,Lekki,ilasan lekki lagos,2,7,4,3,4,0,0,0,0,7,21000000
1701,Lekki,lekki phase 2 lekki lagos,2,2,1,1,1,0,0,0,0,4,6825000
1702,Lekki,fola osibo lekki phase 1 lekki lagos,2,13,7,6,7,1,1,0,1,10,71400000
1703,Lekki,close to the spar ikate lekki lagos,2,8,4,4,4,1,0,0,1,7,31500000
1704,Lekki,agungi lekki lagos,2,2,1,1,1,0,0,0,1,4,10500000
1705,Lekki,megamound estate ikota lekki lagos,2,9,5,4,5,1,1,1,1,9,58800000
1706,Lekki,orchid road ikota lekki lagos,2,8,4,4,4,1,0,0,1,7,31500000
1707,Lekki,osapa osapa london lekki lagos,2,7,4,3,4,0,0,0,0,7,21000000
1708,Lekki,osapa osapa london lekki lagos,2,11,6,5,6,1,1,0,1,10,65100000
1709,Lekki,chevron chevron lekki lagos,2,9,5,4,5,0,0,0,1,9,36750000
1710,Lekki," ikate elegushi, ikate lekki lagos",2,7,4,3,4,0,0,0,1,7,26250000
1711,Lekki,igbo efon lekki lagos,2,7,4,3,4,0,0,0,0,7,21000000
1712,Lekki,lekki paradise 3 estate chevron lekki lagos,2,7,4,3,4,0,0,0,1,7,26250000
1713,Lekki,ikota villa estate ikota lekki ikota lekki lagos,2,2,1,1,1,0,0,0,0,4,5250000
1714,Lekki,lekki lagos lekki phase 1 lekki lagos,2,8,4,4,4,0,0,0,1,7,29400000
1715,Lekki," united estate, sangotedo, ajah axis, lekki. sangotedo ajah lagos",2,4,2,2,2,0,0,0,0,6,9450000
1716,Lekki,off osapa agungi lekki lagos,2,2,1,1,1,0,0,0,1,4,8925000
1717,Lekki,orchid road ikota lekki lagos,2,8,4,4,4,1,0,0,1,7,31500000
1718,Lekki," majek, opposite fara park, in ajah axis lekki. crown estate ajah lagos",2,4,2,2,2,0,0,0,0,6,9450000
1719,Lekki," megamound avenue, ikota villa estate lekki lagos",2,11,6,5,6,0,0,0,0,10,49350000
1720,Lekki,ibeju lekki lagos,2,2,1,1,1,0,0,0,0,4,4200000
1721,Lekki,. lekki phase 1 lekki lagos,2,8,4,4,4,0,0,0,1,7,26250000
1722,Lekki,osapa london lekki lagos,2,6,3,3,3,0,0,0,0,7,15750000
1723,Lekki,ikate lekki lagos,2,10,5,5,5,1,1,1,1,9,58800000
1724,Lekki,victory park osapa london lekki lagos,2,12,6,6,6,1,1,0,1,10,65100000
1725,Lekki,lekki phase 1 lekki phase 1 lekki lagos,2,7,4,3,4,1,1,1,1,7,42000000
1726,Lekki,yeye olofin street lekki phase 1 lekki lagos,2,4,2,2,2,1,0,0,1,6,17850000
1727,Lekki,ikate lekki lagos,2,4,2,2,2,1,1,1,1,6,31500000
1728,Lekki,ikate lekki lagos,2,8,4,4,4,1,1,1,1,7,45150000
1729,Lekki,osapa osapa london lekki lagos,2,2,1,1,1,0,0,0,1,4,8400000
1730,Lekki,spg road ologolo lekki lagos,2,2,1,1,1,1,0,0,1,4,12600000
1731,Lekki,idado estate lekki lagos idado lekki lagos,2,7,4,3,4,0,0,0,0,7,21000000
1732,Lekki,osapa osapa london lekki lagos,2,2,1,1,1,0,0,0,0,4,5250000
1733,Lekki," estate, agungi lekki lagos",2,2,1,1,1,0,0,0,0,4,4200000
1734,Lekki,idado idado lekki lagos,2,7,4,3,4,0,0,0,0,7,21000000
1735,Lekki,before blenco supermarket in olokonla in ajah axis lekki. olokonla ajah lagos,2,6,3,3,3,0,0,0,0,7,10500000
1736,Lekki,ikate lekki lagos,2,8,4,4,4,1,0,0,1,7,31500000
1737,Lekki,ologolo road ologolo lekki lagos,2,7,4,3,4,0,0,0,1,7,26250000
1738,Lekki,off admiralty lekki phase 1 lekki lagos,2,7,4,3,4,0,0,0,0,7,23100000
1739,Lekki,orchid road lekki lagos,2,9,5,4,5,1,0,0,1,9,42000000
1740,Lekki," idado ext., agungi lekki lagos",2,2,1,1,1,0,0,0,0,4,4200000
1741,Lekki,.. idado lekki lagos,2,2,1,1,1,0,0,0,1,4,9450000
1742,Lekki,.. idado lekki lagos,2,2,1,1,1,0,0,0,0,4,7350000
1743,Lekki," ikota gra, ikota villa ikota lekki lagos",2,5,3,2,3,0,0,0,0,7,17850000
1744,Lekki,shoprite road osapa london lekki lagos,2,3,2,1,2,0,0,0,1,6,15750000
1745,Lekki,atlantic view estate alpha beach road lekki lagos,2,2,1,1,1,0,0,0,0,4,5250000
1746,Lekki,lekki scheme 2 abraham adesanya ogombo road ajah ogombo ajah lagos,2,5,3,2,3,0,0,0,0,7,10500000
1747,Lekki,agungi lekki lagos,2,2,1,1,1,0,0,0,1,4,8925000
1748,Lekki,southern view estate ikota lekki lagos,2,3,2,1,2,0,0,0,0,6,9450000
1749,Lekki,lekki scheme 2 abraham adesanya ogombo road ajah ilaje ajah lagos,2,7,4,3,4,0,0,0,0,7,21000000
1750,Lekki,off ayo babatunde street oniru lekki phase 1 lekki lagos,2,7,4,3,4,1,0,0,1,7,31500000
1751,Lekki,osapa london lekki lagos,2,7,4,3,4,0,0,0,0,7,21000000
1752,Lekki," oceanbay estate, lafiaji chevron lekki lagos",2,7,4,3,4,1,1,1,1,7,42000000
1753,Lekki,eleganza gardens vgc lekki lagos,2,7,4,3,4,0,0,0,0,7,21000000
1754,Lekki,12e admiralty way opposite skybox lekki phase 1 lekki lagos,2,2,1,1,1,1,1,1,1,4,13650000
1755,Lekki,12e admiralty way opposite skybox lekki phase 1 lekki lagos,2,2,1,1,1,0,0,0,1,4,10500000
1756,Lekki,chevron lekki lagos,2,10,5,5,5,1,0,0,1,9,42000000
1757,Lekki,chevron lekki lagos,2,10,5,5,5,1,0,0,1,9,42000000
1758,Lekki,hi lekki phase 1 lekki lagos,2,2,1,1,1,1,1,1,1,4,15750000
1759,Lekki,h lekki phase 1 lekki lagos,2,2,1,1,1,1,1,1,1,4,14700000
1760,Lekki,lekki phase 1 lekki lagos,2,11,6,5,6,0,0,0,1,10,63000000
1761,Lekki,lekki phase 1 lekki lagos,2,9,5,4,5,1,1,1,1,9,58800000
1762,Lekki,lekki phase 1 lekki phase 1 lekki lagos,2,15,8,7,8,1,1,0,1,10,73500000
1763,Lekki,off platinum way lekki phase 2 lekki phase 2 lekki lagos,2,9,5,4,5,0,0,0,1,9,36750000
1764,Lekki,chervon alternative road lekki lagos. chevron lekki lagos,2,12,6,6,6,1,1,0,1,10,65100000
1765,Lekki," safe court estate ikate,elegushi lekki. ikate lekki lagos",2,7,4,3,4,1,0,0,1,7,31500000
1766,Lekki," safe court estate ikate, elegushi lekki, ikate lekki lagos",2,7,4,3,4,1,0,0,1,7,31500000
1767,Lekki,horizon 11 estate via meadow hall way. ikate lekki lagos,2,7,4,3,4,0,0,0,1,7,28875000
1768,Lekki," lekki palm city estate, opposite ecobank ado road ajah lagos ado ajah lagos",2,5,3,2,3,0,0,0,0,7,14700000
1769,Lekki,off orchid hotel road chevron lekki lagos,2,9,5,4,5,0,0,0,1,9,36750000
1770,Lekki,34 agungi road agungi lekki lagos,2,5,2,3,2,1,1,1,1,6,31500000
1771,Lekki,chief collins lekki phase 1 lekki lagos,2,3,1,2,1,1,0,0,1,4,12600000
1772,Lekki,oba amusa adebambo avenue agungi lekki lagos,2,2,1,1,1,0,0,0,0,4,4200000
1773,Lekki,"25, ganiu eletu, street awoyaya eputu ibeju lekki lagos",2,4,2,2,2,0,0,0,0,6,9450000
1774,Lekki,idado estate idado lekki lagos,2,5,3,2,3,1,1,0,1,7,26250000
1775,Lekki,ikate ikate lekki lagos,2,5,3,2,3,0,0,0,1,7,21000000
1776,Lekki," shoprite road, osapa london lekki lagos",2,2,1,1,1,0,0,0,0,4,7875000
1777,Lekki,lekki phase 1 lekki phase 1 lekki lagos,2,2,1,1,1,0,0,0,1,4,10500000
1778,Lekki," idado ext., idado lekki lagos",2,2,1,1,1,0,0,0,0,4,7350000
1779,Lekki,.. igbo efon lekki lagos,2,2,1,1,1,0,0,0,0,4,4200000
1780,Lekki,shoprite road osapa london lekki lagos,2,5,3,2,3,0,0,0,1,7,21000000
1781,Lekki,- igbo efon lekki lagos,2,3,2,1,2,0,0,0,0,6,9450000
1782,Lekki,megamound estate lekki country homes ikota ikota lekki lagos,2,11,6,5,6,0,0,0,0,10,49350000
1783,Lekki,2nd avenue lekki phase 1 lekki lagos,2,6,3,3,3,0,0,0,0,7,18900000
1784,Lekki,2 avenue lekki phase 1 lekki lagos,2,8,4,4,4,0,0,0,0,7,21000000
1785,Lekki,.. ologolo lekki lagos,2,6,3,3,3,0,0,0,0,7,15750000
1786,Lekki,horizon 11 estate via meadow hall way ikate elegushi. ikate lekki lagos,2,7,4,3,4,0,0,0,1,7,28875000
1787,Lekki,lekki phase 1 lekki lagos,2,5,3,2,3,1,1,1,1,7,29400000
1788,Lekki,lekki phase 1 lekki lagos,2,11,6,5,6,0,0,0,1,10,63000000
1789,Lekki,prince olanrewaju elegushi street ikate lekki lagos,2,5,3,2,3,0,0,0,0,7,10500000
1790,Lekki,chevron lekki phase 1 lekki lagos,2,2,1,1,1,0,0,0,1,4,8400000
1791,Lekki," ikate elegushi, lekki lagos",2,2,1,1,1,0,0,0,1,4,8400000
1792,Lekki,no 7 bello close chevy view estate chevron lekki lagos,2,12,6,6,6,0,0,0,0,10,52500000
1793,Lekki,chevron lekki lagos,2,2,1,1,1,1,1,1,1,4,15750000
1794,Lekki,chevron lekki lagos,2,5,3,2,3,0,0,0,1,7,21000000
1795,Lekki," after forte oil before abraham adesanya roundabout, lekki expressway lekki lagos",2,2,1,1,1,0,0,0,0,4,4200000
1796,Lekki,lekki phase 1 lekki lagos,2,4,2,2,2,0,0,0,0,6,12600000
1797,Lekki," main elesekan town road, bogije ibeju lekki lagos",2,7,4,3,4,0,0,0,0,7,21000000
1798,Lekki," victoria bay estate, lafiaji lekki lagos",2,5,3,2,3,1,1,0,1,7,26250000
1799,Lekki," victoria bay estate, lafiaji lekki lagos",2,7,4,3,4,0,0,0,1,7,30450000
1800,Lekki," ibrahim odo close, by friend colony gate, off agungi road agungi lekki lagos",2,9,5,4,5,0,0,0,1,9,36750000
1801,Lekki,lekki phase 1 lekki lagos,2,2,1,1,1,1,1,1,1,4,19950000
1802,Lekki,lekki phase 1 lekki phase 1 lekki lagos,2,4,2,2,2,0,0,0,0,6,12600000
1803,Lekki,agungi agungi lekki lagos,2,5,3,2,3,0,0,0,0,7,18900000
1804,Lekki,meadow hall way ikate lekki lagos,2,2,1,1,1,0,0,0,1,4,10500000
1805,Lekki," rdp apartments, beechwood park estate, lekki express way ibeju- lekki eleko ibeju lekki lagos",2,6,3,3,3,0,0,0,0,7,10500000
1806,Lekki,palm spring road ikate lekki lagos,2,6,3,3,3,1,1,1,1,7,36750000
1807,Lekki,by pinnacle filling station lekki phase 1 lekki lagos,2,11,6,5,6,1,1,0,1,10,65100000
1808,Lekki,lake view estate orchid road estate lekki phase 1 lekki lagos,2,7,4,3,4,0,0,0,1,7,26250000
1809,Lekki,bakare estate agungi lekki lagos,2,2,1,1,1,0,0,0,0,4,6825000
1810,Lekki,ologolo lekki lagos,2,9,5,4,5,0,0,0,1,9,36750000
1811,Lekki,ikota ikota lekki lagos,2,9,5,4,5,0,0,0,1,9,36750000
1812,Lekki,off fola osibo lekki phase 1 lekki lagos,2,7,4,3,4,0,0,0,1,7,28350000
1813,Lekki," earls court, ikate elegushi ikate lekki lagos",2,10,5,5,5,1,1,1,1,9,58800000
1814,Lekki,hakeem dickson lekki phase 1 lekki lagos,2,2,1,1,1,0,0,0,1,4,10500000
1815,Lekki," chevron drive, chevron lekki lagos",2,2,1,1,1,0,0,0,0,4,6300000
1816,Lekki,lekki phase 1 lekki phase 1 lekki lagos,2,5,3,2,3,1,1,0,1,7,26250000
1817,Lekki," ikate elegushi, ikate lekki lagos",2,2,1,1,1,1,1,1,1,4,21000000
1818,Lekki,adiva estate ibeju lekki lagos,2,6,3,3,3,0,0,0,0,7,10500000
1819,Lekki,adiva estate ibeju lekki lagos,2,6,3,3,3,0,0,0,0,7,10500000
1820,Lekki,olanrewaju elegushi street ilasan lekki lagos,2,5,3,2,3,0,0,0,0,7,10500000
1821,Lekki,ologolo lekki lagos,2,9,5,4,5,0,0,0,1,9,36750000
1822,Lekki,ologolo lekki lagos,2,9,5,4,5,0,0,0,1,9,36750000
1823,Lekki,located at ikota villa estate behind mega chicken ikota lekki lagos,2,9,5,4,5,0,0,0,1,9,36750000
1824,Lekki," eric's place, behind spar on palm springs road ikate lekki lagos",2,7,4,3,4,1,1,1,1,7,45150000
1825,Lekki,agungi agungi lekki lagos,2,4,2,2,2,0,0,0,0,6,12600000
1826,Lekki," ikate elegushi, ikate lekki lagos",2,7,4,3,4,0,0,0,0,7,24150000
1827,Lekki," lakowe lakes and country homes (golf resort), lakowe ibeju lekki lagos",2,9,5,4,5,0,0,0,1,9,36750000
1828,Lekki,"off george enenmoh street, lekki phase 1 lekki lagos",2,2,1,1,1,0,0,0,1,4,10500000
1829,Lekki," ikate elegushi, ikate lekki lagos",2,8,4,4,4,0,0,0,0,7,21000000
1830,Lekki,lekki phase 1 lekki phase 1 lekki lagos,2,9,5,4,5,0,0,0,1,9,36750000
1831,Lekki,ikota ikota lekki lagos,2,9,5,4,5,0,0,0,1,9,36750000
1832,Lekki,off adekunle kuye adelabu lekki lagos,2,2,1,1,1,0,0,0,1,4,10500000
1833,Lekki,"muri sodiq drive, off spg road, lekki lekki phase 1 lekki lagos",2,7,4,3,4,0,0,0,1,7,29400000
1834,Lekki,prince kazeem eletu street osapa london osapa london lekki lagos,2,2,1,1,1,0,0,0,0,4,5250000
1835,Lekki,road 6 blook 56 chevron lekki lagos,2,2,1,1,1,0,0,0,0,4,6825000
1836,Lekki,okera-nla lekki ajah lagos ado ajah lagos,2,2,1,1,1,0,0,0,0,4,4200000
1837,Lekki,"ocean bay estate, lekki peninsula 2 lekki phase 2 lekki lagos",2,8,5,3,5,0,0,0,1,9,36750000
1838,Lekki,agungi agungi lekki lagos,2,2,1,1,1,1,0,0,1,4,12600000
1839,Lekki,"off oladimeji alo street, lekki phase 1 lekki lagos",2,2,1,1,1,0,0,0,0,4,6300000
1840,Lekki,"off oladimeji alo street, lekki phase 1 lekki lagos",2,2,1,1,1,0,0,0,0,4,6300000
1841,Lekki,orchid estate ologolo lekki lagos,2,2,1,1,1,0,0,0,0,4,4200000
1842,Lekki,lekki lekki phase 1 lekki lagos,2,2,1,1,1,0,0,0,0,4,4200000
1843,Lekki," ikota, lekki lekki lagos",2,5,3,2,3,0,0,0,0,7,16800000
1844,Lekki,osapa osapa london lekki lagos,2,9,5,4,5,1,1,1,1,9,52500000
1845,Lekki,gra ikota lekki lagos,2,9,5,4,5,1,1,1,1,9,58800000
1846,Lekki,lagasa rd oribanwa ibeju lekki lagos,2,2,1,1,1,0,0,0,0,4,4200000
1847,Lekki," shapati, bogije ibeju lekki lagos",2,5,3,2,3,0,0,0,0,7,10500000
1848,Lekki,lekky county estate ikota lekki lagos,2,10,5,5,5,0,0,0,1,9,36750000
1849,Lekki,new road/alfa beach road lekki lagos,2,2,1,1,1,0,0,0,0,4,4200000
1850,Lekki,agungi lekki lagos,2,7,4,3,4,0,0,0,0,7,21000000
1851,Lekki,.. ikate lekki lagos,2,7,4,3,4,0,0,0,0,7,21000000
1852,Lekki,- lekki phase 1 lekki lagos,2,5,3,2,3,0,0,0,0,7,17850000
1853,Lekki,jakande jakande lekki lagos,2,2,1,1,1,1,1,1,1,4,13650000
1854,Lekki,agungi lekki lagos,2,2,1,1,1,0,0,0,1,4,11550000
1855,Lekki,.. ikate lekki lagos,2,6,3,3,3,0,0,0,0,7,17850000
1856,Lekki,idado idado lekki lagos,2,8,4,4,4,0,0,0,1,7,26250000
1857,Lekki,agungi agungi lekki lagos,2,5,3,2,3,0,0,0,1,7,21000000
1858,Lekki,directly off fola osibo lekki phase 1 lekki lagos,2,12,6,6,6,1,1,0,1,10,65100000
1859,Lekki,gbo efon igbo efon lekki lagos,2,7,4,3,4,0,0,0,0,7,21000000
1860,Lekki,chevron drive lekki phase 2 lekki lagos,2,12,6,6,6,0,0,0,0,10,52500000
1861,Lekki,idado estates idado lekki lagos,2,7,4,3,4,0,0,0,0,7,21000000
1862,Lekki,osapa osapa london lekki lagos,2,9,5,4,5,1,0,1,1,9,47250000
1863,Lekki,osapa osapa london lekki lagos,2,11,6,5,6,0,0,0,0,10,49350000
1864,Lekki,- lekki lagos,2,10,5,5,5,1,1,1,1,9,58800000
1865,Lekki,lekki county estate ikota lekki lagos,2,6,3,3,3,1,1,0,1,7,28665000
1866,Lekki,orchid road victoria crest estate lekki lagos,2,10,5,5,5,0,0,0,1,9,36750000
1867,Lekki," bakare estate, in a gated secured estate agungi lekki lagos",2,5,3,2,3,0,0,0,0,7,16800000
1868,Lekki,osapa osapa london lekki lagos,2,7,4,3,4,1,0,0,1,7,31500000
1869,Lekki," orchid, lafiaji lekki lagos",2,9,5,4,5,0,0,0,1,9,36750000
1870,Lekki,osapa osapa london lekki lagos,2,6,3,3,3,1,1,0,1,7,26250000
1871,Lekki,agungi lekki lagos,2,7,4,3,4,0,0,0,0,7,21000000
1872,Lekki,lafiaji lekki lagos,2,9,5,4,5,0,0,0,1,9,36750000
1873,Lekki,chevron chevron lekki lagos,2,5,3,2,3,0,0,0,0,7,18900000
1874,Lekki,ologolo ologolo lekki lagos,2,6,3,3,3,0,0,0,0,7,10500000
1875,Lekki,off castle and temp drive lekki lekki phase 1 lekki lagos,2,7,4,3,4,1,1,1,1,7,45150000
1876,Lekki,off omorire johnson lekki phase 1 lekki lagos,2,9,5,4,5,1,1,1,1,9,58800000
1877,Lekki,ikate lekki lagos,2,8,4,4,4,1,1,1,1,7,42000000
1878,Lekki,off admirality way lekki phase1 lekki phase 1 lekki lagos,2,7,4,3,4,1,1,1,1,7,45150000
1879,Lekki,in a well secured estate ikota lekki lagos,2,5,3,2,3,0,0,0,0,7,16800000
1880,Lekki,117 opebi road ikeja agungi lekki lagos,2,3,2,1,2,0,0,0,0,6,12600000
1881,Lekki,elegushi lekki phase 1 lekki lagos,2,8,4,4,4,0,0,0,1,7,26250000
1882,Lekki,lekki phase 1 lekki lagos,2,10,5,5,5,0,0,0,1,9,36750000
1883,Lekki,lekki phase 1 lekki phase 1 lekki lagos,2,12,6,6,6,1,1,0,1,10,65100000
1884,Lekki,jakande jakande lekki lagos,2,9,5,4,5,0,0,0,1,9,36750000
1885,Lekki,lekki lekki phase 1 lekki lagos,2,11,6,5,6,1,1,0,1,10,65100000
1886,Lekki,... chevron lekki lagos,2,8,4,4,4,1,1,1,1,7,45150000
1887,Lekki,6th avenue eletu osapa london osapa london lekki lagos,2,12,6,6,6,0,0,0,0,10,52500000
1888,Lekki,gabriel okoi street ikate lekki lagos,2,7,4,3,4,0,0,0,0,7,24150000
1889,Lekki,"off admiralty way, lekki phase 1,1 lekki phase 1 lekki lagos",2,2,1,1,1,1,1,1,1,4,15750000
1890,Lekki,maruwa lekki phase 1 lekki lagos,2,9,5,4,5,1,0,0,1,9,42000000
1891,Lekki,behind elevation church ilasan lekki lagos,2,9,5,4,5,0,0,0,1,9,36750000
1892,Lekki,chevyview estate chevron lekki lagos,2,6,3,3,3,1,1,1,1,7,31500000
1893,Lekki,.. osapa london lekki lagos,2,7,4,3,4,0,0,0,0,7,21000000
1894,Lekki,.. osapa london lekki lagos,2,9,5,4,5,0,0,0,1,9,36750000
1895,Lekki,osapa osapa london lekki lagos,2,4,2,2,2,1,1,1,1,6,26250000
1896,Lekki,horizon 2 lekki gardens ikate lagos ikate lekki lagos,2,10,5,5,5,1,1,1,1,9,52500000
1897,Lekki,lafiaji lekki phase 1 lekki lagos,2,9,5,4,5,0,0,0,1,9,36750000
1898,Lekki,divine estate lekki phase 1 lekki lagos,2,4,2,2,2,1,1,1,1,6,26250000
1899,Lekki,chevy view alternative route vgc lekki lagos,2,10,5,5,5,1,0,0,1,9,42000000
1900,Lekki,jakande lekki lagos,2,2,1,1,1,1,0,0,1,4,12600000
1901,Lekki," lafiaji, lekki lagos",2,9,5,4,5,0,0,0,1,9,36750000
1902,Lekki," kazeem eletu way osapa london, osapa london lekki lagos",2,11,6,5,6,0,0,0,0,10,49350000
1903,Lekki,"second lekki toll gate, orchid lekki phase 2 lekki lagos",2,8,4,4,4,1,1,1,1,7,44100000
1904,Lekki,lekki phase 1 lekki phase 1 lekki lagos,2,11,6,5,6,1,1,0,1,10,65100000
1905,Lekki," lafiaji, lekki lagos",2,10,6,4,6,0,0,0,0,10,49350000
1906,Lekki,horison court ikate lekki lagos,2,3,2,1,2,1,0,0,1,6,18900000
1907,Lekki,- ikota lekki lagos,2,9,5,4,5,0,0,0,1,9,36750000
1908,Lekki,spring bey estate off freedom way lekki phase 1 lekki lagos,2,11,6,5,6,0,0,0,0,10,49350000
1909,Lekki," adegbenle street, chevy view estate, chevron drive, lekki osapa london lekki lagos",2,9,5,4,5,0,0,0,1,9,36750000
1910,Lekki,osapa osapa london lekki lagos,2,9,5,4,5,0,0,0,1,9,36750000
1911,Lekki,lekki county estate lekki lekki phase 1 lekki lagos,2,9,5,4,5,1,0,1,1,9,47250000
1912,Lekki," friends colony estate, agungi agungi lekki lagos",2,9,5,4,5,0,0,0,1,9,36750000
1913,Lekki," friends colony, agungi axis agungi lekki lagos",2,9,5,4,5,0,0,0,1,9,36750000
1914,Lekki,ikate elegushi ikate lekki lagos,2,7,4,3,4,0,0,0,1,7,26250000
1915,Lekki,. lekki phase 1 lekki lagos,2,9,5,4,5,1,0,0,1,9,42000000
1916,Lekki,lekki chevron lagos chevron lekki lagos,2,10,5,5,5,0,0,0,1,9,36750000
1917,Lekki," beside earl court, ikate elegushi, lagos state ikate lekki lagos",2,9,5,4,5,1,0,0,1,9,42000000
1918,Lekki,orchid road lekki phase 1 lekki lagos,2,11,6,5,6,0,0,0,0,10,49350000
1919,Lekki,maruwa lekki lagos,2,9,5,4,5,0,0,0,1,9,36750000
1920,Lekki,orchid road chevron lekki lagos,2,9,5,4,5,0,0,0,1,9,36750000
1921,Lekki,chevron lekki lagos,2,8,5,3,5,0,0,0,1,9,39900000
1922,Lekki,the grantham estate lekki phase 2 lekki lagos,2,9,5,4,5,0,0,0,1,9,36750000
1923,Lekki,ilasan lekki lagos,2,6,3,3,3,0,0,0,1,7,23100000
1924,Lekki,emcel court ikota gra lekki ikota lekki lagos,2,11,5,6,5,0,0,0,1,9,36750000
1925,Lekki,ikate lekki lagos,2,6,3,3,3,1,1,0,1,7,26250000
1926,Lekki,osapa london lekki lagos,2,11,6,5,6,0,0,0,0,10,49350000
1927,Lekki,bera estate chevron lekki lagos,2,11,6,5,6,0,0,0,0,10,49350000
1928,Lekki,admiralty road lekki phase 1 lekki phase 1 lekki lagos,2,11,6,5,6,1,1,0,1,10,65100000
1929,Lekki,chief augustine anozie lekki phase 1 lekki lagos,2,3,1,2,1,1,1,1,1,4,21000000
1930,Lekki,chief augustine anozie lekki phase 1 lekki lagos,2,7,2,5,2,1,1,1,1,6,31500000
1931,Lekki,chesachi hani-okoroafor close lekki phase 1 lekki lagos,2,13,7,6,7,0,0,0,0,10,57750000
1932,Lekki," bogije along lekki/epe express way ,lagos lacampaigne tropicana ibeju lekki lagos",2,6,3,3,3,1,1,1,1,7,36750000
1933,Lekki,ajah lekki gardens estate ajah lagos,2,10,5,5,5,1,1,1,1,9,58800000
1934,Lekki," chevron, lekki, lagos chevron lekki lagos",2,9,5,4,5,0,0,0,1,9,36750000
1935,Lekki," ologolo street, off lekki epe express, by dominos agungi. lekki lagos agungi lekki lagos",2,11,6,5,6,0,0,0,0,10,49350000
1936,Lekki,ologolo road agungi lekki lagos,2,9,5,4,5,0,0,0,1,9,36750000
1937,Lekki," mayfair garden estate, awoyaya eputu ibeju lekki lagos",2,7,4,3,4,0,0,0,0,7,21000000
1938,Lekki,marwa lekki phase 1 lekki lagos,2,9,5,4,5,1,0,0,1,9,42000000
1939,Lekki,university view estate opposite lagos business school off lekki epe expressway ajah lagos,2,2,1,1,1,0,0,0,0,4,5250000
1940,Ogba,obawole area ifako ogba ogba lagos,3,6,3,3,3,0,0,0,0,3,5250000
1941,Ogba,obawole area ifako ogba ogba lagos,3,2,1,1,1,0,0,0,0,1,1260000
1942,Ogba,obawole area ifako ogba ogba lagos,3,5,3,2,3,0,0,0,1,3,6825000
1943,Ogba,off college road ifako ogba ogba lagos,3,4,2,2,2,0,0,0,0,3,4200000
1944,Ogba,at obawole area ifako ogba ogba lagos,3,2,1,1,1,0,0,0,0,1,2100000
1945,Ogba,college road ifako ogba ogba lagos,3,2,1,1,1,0,0,0,0,1,1785000
1946,Ogba,off college road ifako ogba ogba lagos,3,4,2,2,2,0,0,0,1,3,6300000
1947,Ogba,obawole area ifako ogba ogba lagos,3,2,1,1,1,0,0,0,0,1,1890000
1948,Ogba,obawole area ifako ogba ogba lagos,3,2,1,1,1,0,0,0,1,1,2625000
1949,Ogba,obawole area ifako ogba ogba lagos,3,4,2,2,2,0,0,0,0,3,4200000
1950,Ogba,obawole area ifako ogba ogba lagos,3,7,4,3,4,0,0,0,0,4,7350000
1951,Ogba,near airtel office aguda(ogba) ogba lagos,3,4,2,2,2,1,1,0,1,3,6825000
1952,Ogba,obawole area ifako ogba ogba lagos,3,7,4,3,4,0,0,0,0,4,7875000
1953,Ogba,off college road ifako ogba ogba lagos,3,6,3,3,3,1,1,1,1,3,10500000
1954,Ogba,obawole area ifako ogba ogba lagos,3,6,3,3,3,0,0,0,0,3,6300000
1955,Ogba,obawole area ifako ogba ogba lagos,3,5,3,2,3,0,0,0,0,3,5250000
1956,Ogba,obawole area ifako ogba ogba lagos,3,6,3,3,3,0,0,0,1,3,6825000
1957,Ogba,obawole area ifako ogba ogba lagos,3,2,1,1,1,0,0,0,0,1,1260000
1958,Ogba,"  kay farm estate, obawale, ogba ikeja lagos",3,5,3,2,3,0,0,0,1,3,6825000
1959,Ogba,kay farm estate obawole ogba lagos ogba lagos,3,5,3,2,3,0,0,0,1,3,6825000
1960,Ogba,behind nationwide filling station.... aguda(ogba) ogba lagos,3,2,1,1,1,1,0,0,1,1,3150000
1961,Ogba,kay farm estate off college road ogba aguda(ogba) ogba lagos,3,4,2,2,2,0,0,0,0,3,5250000
1962,Ogba,kadiri street...... ajayi road ogba lagos,3,2,1,1,1,1,0,1,1,1,3675000
1963,Ogba,karaole estate..off college road..... ifako ogba ogba lagos,3,2,1,1,1,0,0,0,0,1,2310000
1964,Ogba,off power line obawole ifako ogba ogba lagos,3,2,1,1,1,1,0,0,1,1,3150000
1965,Ogba,aguda(ogba) ogba lagos,3,2,1,1,1,1,1,1,1,1,3990000
1966,Ogba,aguda area..... ajayi road ogba lagos,3,8,4,4,4,0,0,0,1,4,8400000
1967,Ogba,olanipekun estate...... ajayi road ogba lagos,3,2,1,1,1,1,1,1,1,1,3990000
1968,Ogba,mobil.....ola street...... ajayi road ogba lagos,3,6,3,3,3,1,0,0,1,3,7875000
1969,Ogba,mobil area..... ajayi road ogba lagos,3,6,3,3,3,0,0,0,1,3,6825000
1970,Ogba," haruna area,off college road.... ogba lagos",3,4,2,2,2,0,0,0,0,3,5250000
1971,Ogba,ogba aguda(ogba) ogba lagos,3,3,2,1,2,1,1,1,1,3,7350000
1972,Ogba,jacob shonola street...... ajayi road ogba lagos,3,6,3,3,3,0,0,0,1,3,7350000
1973,Ogba,yusufu street...... ajayi road ogba lagos,3,6,3,3,3,1,1,0,1,3,8400000
1974,Ogba,oke-ira...... ajayi road ogba lagos,3,6,3,3,3,0,0,0,1,3,6825000
1975,Ogba,oladoyinbo street...... aguda(ogba) ogba lagos,3,4,2,2,2,1,1,0,1,3,6825000
1976,Ogba,off ajayi road ajayi road ogba lagos,3,2,1,1,1,1,0,0,1,1,3150000
1977,Ogba,ayo alabi area....... ajayi road ogba lagos,3,4,2,2,2,0,0,0,0,3,4200000
1978,Ogba,oyatogun street ajayi road ogba lagos,3,2,1,1,1,1,0,0,1,1,3150000
1979,Ogba,off college road ifako ogba ogba lagos,3,4,2,2,2,0,0,0,0,3,5250000
1980,Ogba,shonola street....... aguda(ogba) ogba lagos,3,2,1,1,1,1,1,1,1,1,3990000
1981,Ogba,iju obawole ifako ogba ogba lagos,3,2,1,1,1,0,0,0,0,1,2100000
1982,Ogba,oke-ira..... ajayi road ogba lagos,3,8,4,4,4,0,0,0,0,4,7350000
1983,Ogba,obawole iju ogba iju lagos,3,6,3,3,3,1,0,0,1,3,7875000
1984,Ogba,off lucas street ifako ogba ogba lagos,3,5,3,2,3,0,0,0,1,3,6825000
1985,Ogba,oke ira ogba lagos,3,2,1,1,1,1,1,1,1,1,5250000
1986,Ogba,modupe area..... ajayi road ogba lagos,3,4,2,2,2,0,0,0,1,3,5775000
1987,Ogba,ajayi road ogba lagos,3,4,2,2,2,0,0,0,0,3,5250000
1988,Ogba,ogunshola street..... aguda(ogba) ogba lagos,3,6,3,3,3,0,0,0,0,3,5250000
1989,Ogba,otuba street.oke-ira..... ajayi road ogba lagos,3,2,1,1,1,1,0,0,1,1,3150000
1990,Ogba,fadeyi street..... aguda(ogba) ogba lagos,3,6,3,3,3,0,0,0,0,3,5250000
1991,Ogba,ajayi road..... oke ira ogba lagos,3,4,2,2,2,0,0,0,1,3,6300000
1992,Ogba,behind county hospital....... aguda(ogba) ogba lagos,3,4,2,2,2,1,1,0,1,3,6825000
1993,Ogba,alafia estate...... ogba lagos,3,4,2,2,2,0,0,0,1,3,5775000
1994,Ogba,olanipekun estate....... oke ira ogba lagos,3,6,3,3,3,0,0,0,0,3,5250000
1995,Ogba,oke ira ogba lagos,3,6,3,3,3,0,0,0,0,3,5775000
1996,Ogba,behind county hospital..... aguda(ogba) ogba lagos,3,4,2,2,2,1,1,0,1,3,6825000
1997,Ogba,sumonu street..... oke ira ogba lagos,3,2,1,1,1,0,0,0,1,1,2625000
1998,Ogba,aguda ogba area..... ogba lagos,3,6,3,3,3,0,0,0,0,3,5775000
1999,Ogba,aguda(ogba) ogba lagos,3,6,3,3,3,0,0,0,1,3,6825000
2000,Ogba,ajayi road oke-ira.... ogba lagos,3,6,3,3,3,0,0,0,0,3,6300000
2001,Ogba,aguda.... ajayi road ogba lagos,3,6,3,3,3,0,0,0,0,3,6300000
2002,Ogba,aguda...... ifako ogba ogba lagos,3,4,2,2,2,0,0,0,0,3,4200000
2003,Ogba,k farm estate ifako ogba ogba lagos,3,5,3,2,3,0,0,0,1,3,6825000
2004,Ogba,obawole ifako ogba ogba lagos,3,5,3,2,3,0,0,0,0,3,5250000
2005,Ogba,ogundele avenue...... ajayi road ogba lagos,3,2,1,1,1,1,1,1,1,1,4725000
2006,Ogba,ola street...... ajayi road ogba lagos,3,6,3,3,3,0,0,0,1,3,6825000
2007,Ogba,aguda(ogba) ogba lagos,3,6,3,3,3,0,0,0,0,3,5775000
2008,Ogba,alafia estate....... aguda(ogba) ogba lagos,3,4,2,2,2,0,0,0,0,3,4200000
2009,Ogba,aguda(ogba) ogba lagos,3,6,3,3,3,1,1,0,1,3,8400000
2010,Ogba,mobil....... ajayi road ogba lagos,3,6,3,3,3,1,0,0,1,3,7875000
2011,Ogba,fako estate...... oke ira ogba lagos,3,4,2,2,2,0,0,0,1,3,5775000
2012,Ogba,williams estate....... oke ira ogba lagos,3,6,3,3,3,1,1,1,1,3,8925000
2013,Ogba,muibi street...... aguda(ogba) ogba lagos,3,6,3,3,3,0,0,0,0,3,5775000
2014,Ogba,oke-ira.... ajayi road ogba lagos,3,2,1,1,1,0,0,0,0,1,2100000
2015,Ogba,aguda........ ajayi road ogba lagos,3,2,1,1,1,0,0,0,0,1,2100000
2016,Ogba," akilo road,very close to the stadium..... ogba lagos",3,6,3,3,3,1,1,0,1,3,8400000
2017,Ogba,alafia estate..... ogba lagos,3,4,2,2,2,1,1,1,1,3,7350000
2018,Ogba,aguda area.... ogba lagos,3,6,3,3,3,0,0,0,0,3,6300000
2019,Ogba,34 oyatogun street.... aguda(ogba) ogba lagos,3,6,3,3,3,0,0,0,0,3,5775000
2020,Ogba,ogba obawole ifako ogba ogba lagos,3,4,2,2,2,1,1,1,1,3,7350000
2021,Ogba,obawole ifako ogba ogba lagos,3,7,4,3,4,0,0,0,0,4,7875000
2022,Ogba,oke-ira........ ajayi road ogba lagos,3,4,2,2,2,0,0,0,0,3,4725000
2023,Ogba,fadunsi street...... oke ira ogba lagos,3,6,3,3,3,0,0,0,0,3,5775000
2024,Ogba,behind county hospital.... aguda(ogba) ogba lagos,3,4,2,2,2,1,1,0,1,3,6825000
2025,Ogba,behind nationwide filling station..... aguda(ogba) ogba lagos,3,2,1,1,1,1,0,0,1,1,3150000
2026,Ogba,ola street..... ajayi road ogba lagos,3,6,3,3,3,0,0,0,0,3,5775000
2027,Ogba,modupe oke-ira.... ajayi road ogba lagos,3,2,1,1,1,0,0,0,0,1,1890000
2028,Ogba,k farm estate ifako ogba ogba lagos,3,7,4,3,4,0,0,0,0,4,7350000
2029,Ogba,okeira ifako ogba ogba lagos,3,5,3,2,3,1,1,0,1,3,8400000
2030,Ogba,okeira ogba ifako ogba ogba lagos,3,5,3,2,3,0,0,0,1,3,7350000
2031,Ogba,ogundele avenue..... oke ira ogba lagos,3,6,3,3,3,0,0,0,0,3,6300000
2032,Ogba,muibi street....... aguda(ogba) ogba lagos,3,6,3,3,3,0,0,0,0,3,5250000
2033,Ogba,ondo street...... oke ira ogba lagos,3,4,2,2,2,0,0,0,0,3,5250000
2034,Ogba,off ajayi road...... oke ira ogba lagos,3,4,2,2,2,0,0,0,0,3,5250000
2035,Ogba,oladoyinbo street..... aguda(ogba) ogba lagos,3,4,2,2,2,1,1,1,1,3,7350000
2036,Ogba,aguda area...... ogba lagos,3,6,3,3,3,0,0,0,0,3,5250000
2037,Ogba,adeshina street..... ajayi road ogba lagos,3,6,3,3,3,0,0,0,0,3,5250000
2038,Ogba,shonola street....... aguda(ogba) ogba lagos,3,2,1,1,1,1,1,1,1,1,5250000
2039,Ogba,opposite williams estate.... oke ira ogba lagos,3,2,1,1,1,0,0,0,0,1,2100000
2040,Ogba,off college road ifako ogba ogba lagos,3,2,1,1,1,0,0,0,1,1,2625000
2041,Ogba,bintu street.... ajayi road ogba lagos,3,6,3,3,3,1,1,1,1,3,10500000
2042,Ogba,oke ira ogba lagos,3,2,1,1,1,0,0,0,0,1,2100000
2043,Ogba,.. oke ira ogba lagos,3,6,3,3,3,1,1,1,1,3,10500000
2044,Ogba,oke ira ogba lagos,3,6,3,3,3,0,0,0,1,3,7350000
2045,Ogba,obawole area ifako ogba ogba lagos,3,4,2,2,2,0,0,0,0,3,4200000
2046,Ogba,at obawole area ifako ogba ogba lagos,3,7,4,3,4,0,0,0,0,4,7350000
2047,Ogba,oke ira ogba lagos,3,2,1,1,1,1,0,0,1,1,3150000
2048,Ogba,adekoya estate aguda(ogba) ogba lagos,3,9,5,4,5,1,1,0,1,6,15750000
2049,Ogba,oke ira ogba lagos,3,3,2,1,2,0,0,0,0,3,5250000
2050,Ogba,adekoya estate aguda(ogba) ogba lagos,3,7,4,3,4,1,0,0,1,4,10500000
2051,Ogba,kayode street ogba lagos,3,2,1,1,1,1,1,1,1,1,3990000
2052,Ogba,oke ira ogba lagos,3,2,1,1,1,0,0,0,1,1,2625000
2053,Ogba,kfarm estate ifako ogba ogba lagos,3,6,4,2,4,0,0,0,0,4,7350000
2054,Ogba,college road ifako ogba ogba lagos,3,5,3,2,3,0,0,0,0,3,5250000
2055,Ogba,.. oke ira ogba lagos,3,2,1,1,1,0,0,0,0,1,1575000
2056,Ogba,very decent and beautiful 2bedroom at ogba college road ogba lagos,3,4,2,2,2,0,0,0,1,3,6300000
2057,Ogba,oyemekunstreet ogba bus stop ogba lagos,3,6,3,3,3,0,0,0,1,3,7350000
2058,Ogba,college road ifako ogba ogba lagos,3,5,3,2,3,0,0,0,0,3,6300000
2059,Ogba,enahoro estate ogba bus stop ogba lagos,3,3,2,1,2,1,1,1,1,3,8400000
2060,Ogba,oke ira ogba lagos,3,5,3,2,3,1,1,0,1,3,8400000
2061,Ogba,oke ira ogba lagos,3,4,2,2,2,1,1,1,1,3,8400000
2062,Ogba,ifako ogba ogba lagos,3,6,3,3,3,0,0,0,1,3,7350000
2063,Ogba,iju road ifako agege lagos,3,5,3,2,3,0,0,0,0,3,5250000
2064,Ogba,kadiri street oke ira ogba lagos,3,2,1,1,1,1,0,0,1,1,3150000
2065,Ogba,oke ira ogba lagos,3,6,3,3,3,0,0,0,0,3,6300000
2066,Ogba,off college road ogba lagos,3,7,4,3,4,1,0,0,1,4,10500000
2067,Ogba,obawole ogba lagos,3,2,1,1,1,0,0,0,0,1,1785000
2068,Ogba,off college road ogba lagos,3,2,1,1,1,0,0,0,0,1,2100000
2069,Ogba,ajayi road ajayi road ogba lagos,3,4,2,2,2,0,0,0,0,3,4725000
2070,Ogba,college road ifako ogba ogba lagos,3,4,2,2,2,0,0,0,0,3,5250000
2071,Ogba,college road ifako ogba ogba lagos,3,2,1,1,1,1,1,1,1,1,5250000
2072,Ogba,near fadunsi street ajayi road ogba lagos,3,7,4,3,4,1,1,1,1,4,12600000
2073,Ogba,ogba lagos,3,6,3,3,3,0,0,0,0,3,6300000
2074,Ogba,ogba lagos,3,6,3,3,3,0,0,0,1,3,7350000
2075,Ogba,.. ifako ogba ogba lagos,3,10,5,5,5,1,1,0,1,6,15750000
2076,Ogba,off college road ifako ogba ifako ogba ogba lagos,3,4,2,2,2,0,0,0,1,3,6300000
2077,Ogba,off ajayi oke ira ogba lagos,3,8,4,4,4,1,0,0,1,4,10500000
2078,Ogba,ogba off ajayi road oke ira off aguda via excellence hotel. oke ira ogba lagos,3,5,3,2,3,1,1,0,1,3,8400000
2079,Ogba,estate ogba lagos,3,11,5,6,5,1,1,0,1,6,15750000
2080,Ogba,ogba lagos,3,8,4,4,4,1,1,1,1,4,13650000
2081,Ogba,aguda(ogba) ogba lagos,3,6,3,3,3,1,1,1,1,3,10500000
2082,Ogba,oke ira ogba lagos,3,2,1,1,1,1,1,1,1,1,3990000
2083,Ogba,ifako ogba ogba lagos,3,5,3,2,3,0,0,0,1,3,6825000
2084,Ogba,ogba gra ogba gra ogba lagos,3,5,3,2,3,1,1,1,1,3,10500000
2085,Ogba,in a close oke ira ogba lagos,3,5,3,2,3,1,0,0,1,3,7875000
2086,Ogba,ifako ijaiye ifako ogba ogba lagos,3,4,2,2,2,0,0,0,1,3,6300000
2087,Ogba,obawole off ogba ikeja lagos,3,6,3,3,3,1,0,0,1,3,7875000
2088,Ogba,obawole off ogba ikeja lagos,3,6,3,3,3,1,0,0,1,3,7875000
2089,Ogba,ogba lagos,3,4,2,2,2,0,0,0,1,3,6300000
2090,Ogba,before modupe oke ira ajayi road ogba lagos,3,5,3,2,3,1,1,0,1,3,8400000
2091,Ogba," off ayo-alabi street oke-ira, ogba ikeja lagos",3,6,3,3,3,1,0,0,1,3,7875000
2092,Ogba,ogba ikeja lagos,3,7,4,3,4,1,1,1,1,4,12600000
2093,Ikeja,toyin street ikeja lagos,4,8,4,4,4,0,0,0,1,8,39900000
2094,Ikeja,allen avenue ikeja lagos,4,7,4,3,4,1,1,0,1,8,42000000
2095,Ikeja,opebi ikeja lagos,4,13,7,6,7,1,1,0,1,10,71400000
2096,Ikeja,ikeja gra ikeja gra ikeja lagos,4,9,5,4,5,0,0,0,1,9,52500000
2097,Ikeja,toyin street ikeja lagos,4,6,3,3,3,0,0,0,1,6,15750000
2098,Ikeja,"  ikeja gra, ikeja lagos",4,8,5,3,5,0,0,0,0,9,36750000
2099,Ikeja,within an estate adeniyi jones ikeja lagos,4,12,6,6,6,0,0,0,0,10,52500000
2100,Ikeja,ikeja gra ikeja lagos,4,9,5,4,5,1,1,0,1,9,57750000
2101,Ikeja,abc estate adeniyi jones ikeja lagos,4,12,6,6,6,1,1,0,1,10,65100000
2102,Ikeja,"  awuse estate, opebi opebi ikeja lagos",4,7,4,3,4,0,0,0,0,8,21000000
2103,Ikeja,near chrisland schools opebi ikeja lagos,4,7,4,3,4,0,0,0,0,8,21000000
2104,Ikeja,"  awuse estate, opebi, ikeja, lagos opebi ikeja lagos",4,7,4,3,4,0,0,0,0,8,21000000
2105,Ikeja,allen allen avenue ikeja lagos,4,7,4,3,4,1,1,0,1,8,42000000
2106,Ikeja,adeniyi jones ikeja lagos,4,9,5,4,5,0,0,0,0,9,36750000
2107,Ikeja,"  awuse estate, opebi, ikeja, lagos opebi ikeja lagos",4,7,4,3,4,0,0,0,0,8,21000000
2108,Ikeja,"  awuse estate, opebi, ikeja opebi ikeja lagos",4,7,4,3,4,0,0,0,1,8,31500000
2109,Ikeja,off isaac john street ikeja gra ikeja lagos,4,9,5,4,5,0,0,0,1,9,52500000
2110,Ikeja,bamishele estate off allen opebi ikeja lagos,4,7,4,3,4,1,1,0,1,8,42000000
2111,Ikeja,off allen avenue allen avenue ikeja lagos,4,7,4,3,4,1,1,0,1,8,42000000
2112,Ikeja,"  off ogunlani estate, allen, ikeja. allen avenue ikeja lagos",4,12,6,6,6,0,0,0,0,10,49350000
2113,Ikeja,aba johnson street adeniyi jones ikeja lagos,4,15,8,7,8,1,1,0,1,10,73500000
2114,Ikeja,"  awuse estate, obepi, ikeja, lagos opebi ikeja lagos",4,4,2,2,2,1,1,1,1,5,21000000
2115,Ikeja,adeniyi jones ikeja lagos,4,12,6,6,6,0,0,0,0,10,57750000
2116,Ikeja,oba aladejobi street ikeja gra ikeja lagos,4,7,4,3,4,1,1,0,1,8,42000000
2117,Ikeja,"alhaji basheer shittu street magodo shangisha phase 2, ikeja lagos",4,11,6,5,6,0,0,0,1,10,63000000
2118,Ikeja,ikeja gra ikeja gra ikeja lagos,4,9,5,4,5,1,1,0,1,9,57750000
2119,Ikeja,alfred garden estate oregun ikeja oregun ikeja lagos,4,7,4,3,4,1,1,0,1,8,42000000
2120,Ikeja,"  adeniyi jones ikeja, adeniyi jones ikeja lagos",4,7,4,3,4,0,0,0,0,8,21000000
2121,Ikeja,in an estate at adeniyi jones ikeja lagos adeniyi jones ikeja lagos,4,11,6,5,6,0,0,0,0,10,49350000
2122,Ikeja,ikeja gra ikeja lagos,4,7,4,3,4,0,0,0,1,8,33600000
2123,Ikeja,ikeja gra ikeja lagos,4,9,5,4,5,1,1,0,1,9,57750000
2124,Ikeja,adekunle fajuyi ikeja gra ikeja lagos,4,3,2,1,2,0,0,0,1,5,10500000
2125,Ikeja,"  kay farm estate, obawale, ogba ikeja lagos",4,5,3,2,3,0,0,0,0,6,9450000
2126,Ikeja,ikeja gra ikeja lagos,4,9,5,4,5,1,1,0,1,9,57750000
2127,Ikeja,allen avenue ikeja lagos,4,8,5,3,5,0,0,0,0,9,36750000
2128,Ikeja,- ikeja gra ikeja lagos,4,9,5,4,5,1,1,0,1,9,57750000
2129,Ikeja,allen avenue ikeja lagos,4,7,4,3,4,0,0,0,0,8,21000000
2130,Ikeja,titilope street omole estate ph1 agidingbi ikeja lagos,4,11,6,5,6,0,0,0,0,10,52500000
2131,Ikeja,... toyin street ikeja lagos,4,8,4,4,4,0,0,0,0,8,21000000
2132,Ikeja,off adeniyi jones adeniyi jones ikeja lagos,4,14,6,8,6,0,0,0,0,10,52500000
2133,Ikeja,akiode ojodu...... ikeja lagos,4,6,3,3,3,0,0,0,0,6,9450000
2134,Ikeja,"omole ph.1,estate..... ikeja lagos",4,2,1,1,1,1,1,1,1,2,8400000
2135,Ikeja,"omole ph.1,estate.. ikeja lagos",4,10,5,5,5,0,0,0,0,9,36750000
2136,Ikeja,off opebi road opebi ikeja lagos,4,8,4,4,4,0,0,0,1,8,31500000
2137,Ikeja,joel ogunike ikeja gra. lagos mainland ikeja gra ikeja lagos,4,10,5,5,5,0,0,0,0,9,42000000
2138,Ikeja,.river valley estate.ojodu berger. ikeja lagos,4,10,5,5,5,0,0,0,0,9,36750000
2139,Ikeja," ogundele street, ajayi rd.ogba.... ikeja lagos",4,4,2,2,2,0,0,0,0,5,8400000
2140,Ikeja,- adeniyi jones ikeja lagos,4,7,4,3,4,0,0,0,0,8,26250000
2141,Ikeja," adeniyi jones, ikeja, lagos adeniyi jones ikeja lagos",4,6,3,3,3,1,1,1,1,6,36750000
2142,Ikeja,olowora ojodu berger ikeja lagos olowora ojodu lagos,4,7,4,3,4,0,0,0,0,8,21000000
2143,Ikeja,olowora..berger ojodu. ikeja lagos,4,4,2,2,2,0,0,0,0,5,8400000
2144,Ikeja,budland estate ojodu..... ikeja lagos,4,8,4,4,4,0,0,0,0,8,21000000
2145,Ikeja,olutoye crescent adeniyi jones ikeja lagos,4,13,7,6,7,1,1,0,1,10,71400000
2146,Ikeja,fani kayode ikeja gra ikeja lagos,4,9,5,4,5,1,1,0,1,9,57750000
2147,Ikeja,by okupe estate maryland ikeja lagos,4,8,4,4,4,1,1,0,1,8,42000000
2148,Ikeja,afred garden oregun ikeja lagos,4,4,2,2,2,1,0,1,1,5,15750000
2149,Ikeja,ikeja g r a ikeja lagos ikeja gra ikeja lagos,4,9,5,4,5,1,1,0,1,9,57750000
2150,Ikeja,oduduwa street ikeja g r a ikeja lagos ikeja gra ikeja lagos,4,9,5,4,5,1,1,0,1,9,57750000
2151,Ikeja,"opposite omole ph.1,estate gate.... agidingbi ikeja lagos",4,2,1,1,1,0,0,0,0,2,4200000
2152,Ikeja,cement mangoro mangoro ikeja lagos,4,8,4,4,4,0,0,0,0,8,21000000
2153,Ikeja,opebi opebi ikeja lagos,4,7,4,3,4,0,0,0,0,8,24150000
2154,Ikeja,g.r.a ikeja gra ikeja lagos,4,11,6,5,6,1,1,0,1,10,65100000
2155,Ikeja,ikeja ikeja gra ikeja lagos,4,9,5,4,5,1,1,0,1,9,57750000
2156,Ikeja,... maryland ikeja lagos,4,8,4,4,4,0,0,0,0,8,23100000
2157,Ikeja,fani kayode street ikeja ikeja gra ikeja lagos,4,9,5,4,5,1,1,0,1,9,57750000
2158,Ikeja,onipetesi estate mangoro ikeja lagos,4,3,1,2,1,0,0,0,0,2,4200000
2159,Ikeja,valley estate cement ikeja cement agege lagos,4,6,3,3,3,0,0,0,0,6,9450000
2160,Ikeja," ladipo kuku street, off allen avenue, lagos. toyin street ikeja lagos",4,5,3,2,3,0,0,0,0,6,10500000
2161,Ikeja,oduduwa avenue ikeja lagos ikeja gra ikeja lagos,4,9,5,4,5,1,1,0,1,9,57750000
2162,Ikeja,fani kayode street ikeja g r a ikeja lagos ikeja gra ikeja lagos,4,9,5,4,5,1,1,0,1,9,57750000
2163,Ikeja,. allen avenue ikeja lagos,4,12,6,6,6,0,0,0,0,10,49350000
2164,Ikeja,.. adeniyi jones ikeja lagos,4,6,3,3,3,0,0,0,0,6,14700000
2165,Ikeja,ikeja g r a ikeja lagos ikeja gra ikeja lagos,4,9,5,4,5,1,1,0,1,9,57750000
2166,Ikeja,ikeja gra ikeja lagos,4,2,1,1,1,1,1,1,1,2,10500000
2167,Ikeja,ikeja gra ikeja lagos,4,4,2,2,2,0,0,0,1,5,10500000
2168,Ikeja," off awolowo way,ikeja obafemi awolowo way ikeja lagos",4,7,4,3,4,0,0,0,0,8,21000000
2169,Ikeja,adeniyi jones ikeja lagos,4,12,8,4,8,1,1,0,1,10,73500000
2170,Ikeja,ikeja gra ikeja lagos,4,7,4,3,4,1,1,0,1,8,42000000
2171,Ikeja,off toyin street toyin street ikeja lagos,4,6,3,3,3,0,0,0,1,6,15750000
2172,Ikeja," off toyin street,ikeja toyin street ikeja lagos",4,6,3,3,3,0,0,0,0,6,9450000
2173,Ikeja,ikeja gra ikeja lagos,4,10,6,4,6,0,0,0,0,10,49350000
2174,Ikeja,adeniyi jones ikeja lagos,4,7,4,3,4,0,0,0,1,8,31500000
2175,Ikeja,peace estate oregun ikeja lagos,4,9,5,4,5,0,0,0,0,9,36750000
2176,Ikeja,salvation opebi ikeja lagos,4,2,1,1,1,0,0,0,0,2,4200000
2177,Ikeja,off awolowo way obafemi awolowo way ikeja lagos,4,9,5,4,5,0,0,0,0,9,36750000
2178,Ikeja,alausa ikeja lagos,4,7,4,3,4,0,0,0,1,8,36750000
2179,Ikeja,off awolowo way obafemi awolowo way ikeja lagos,4,2,1,1,1,0,0,0,1,2,5250000
2180,Ikeja,off oregun oregun ikeja lagos,4,2,1,1,1,0,0,0,1,2,5250000
2181,Ikeja,off allen avenue allen avenue ikeja lagos,4,2,1,1,1,0,0,0,0,2,4200000
2182,Ikeja,off awolowo way obafemi awolowo way ikeja lagos,4,6,3,3,3,0,0,0,1,6,15750000
2183,Ikeja,off awolowo way awolowo way ikeja lagos,4,4,2,2,2,0,0,0,0,5,8400000
2184,Ikeja,omole phase 1 ikeja gra ikeja lagos,4,12,6,6,6,0,0,0,1,10,63000000
2185,Ikeja,off allen avenue allen avenue ikeja lagos,4,2,1,1,1,0,0,0,0,2,4200000
2186,Ikeja,oduduwa crescent ikeja gra ikeja lagos,4,11,6,5,6,1,1,0,1,10,65100000
2187,Ikeja,alausa ikeja lagos,4,7,4,3,4,0,0,0,1,8,36750000
2188,Ikeja,ikeja gra ikeja lagos,4,7,4,3,4,1,1,0,1,8,42000000
2189,Ikeja,salvation opebi ikeja lagos,4,2,1,1,1,0,0,0,0,2,4200000
2190,Ikeja,off awolowo way obafemi awolowo way ikeja lagos,4,2,1,1,1,1,1,1,1,2,10500000
2191,Ikeja,ikeja gra ikeja lagos,4,7,4,3,4,1,1,0,1,8,42000000
2192,Ikeja,allen avenue ikeja lagos,4,8,4,4,4,0,0,0,1,8,31500000
2193,Ikeja,oregun ikeja lagos,4,6,3,3,3,0,0,0,0,6,10500000
2194,Ikeja,ladoke akintola off isaac john ikeja gra ikeja gra ikeja lagos,4,8,4,4,4,1,1,0,1,8,42000000
2195,Ikeja,remi fani kayode ikeja gra ikeja lagos,4,11,5,6,5,1,1,0,1,9,57750000
2196,Ikeja,amore street off toyin allen ikeja allen avenue ikeja lagos,4,9,5,4,5,0,0,0,0,9,39900000
2197,Ikeja," abel oreniyi street, awuse estate, opebi ikeja opebi ikeja lagos",4,7,4,3,4,0,0,0,0,8,26250000
2198,Ikeja,ikeja lagos,4,8,4,4,4,0,0,0,1,8,31500000
2199,Ikeja,ikeja lagos,4,8,4,4,4,0,0,0,0,8,21000000
2200,Ikeja,ikeja lagos,4,4,2,2,2,1,1,1,1,5,23100000
2201,Ikeja,ikeja gra ikeja lagos,4,8,4,4,4,0,0,0,0,8,26250000
2202,Ikeja,ikeja gra ikeja lagos,4,10,5,5,5,0,0,0,0,9,42000000
2203,Ikeja,ikeja lagos,4,10,5,5,5,0,0,0,0,9,36750000
2204,Ikeja,... adeniyi jones ikeja lagos,4,8,4,4,4,0,0,0,0,8,28350000
2205,Ikeja,adeniyi jones ikeja lagos,4,10,5,5,5,0,0,0,0,9,36750000
2206,Ikeja,opebi ikeja lagos,4,10,5,5,5,0,0,0,0,9,36750000
2207,Ikeja,ikeja lagos,4,6,3,3,3,0,0,0,1,6,15750000
2208,Ikeja,ikeja gra ikeja lagos,4,6,3,3,3,0,0,0,1,6,18900000
2209,Ikeja,ikeja lagos,4,3,2,1,2,0,0,0,0,5,8400000
2210,Ikeja,ikeja lagos,4,10,5,5,5,0,0,0,0,9,36750000
2211,Ikeja,ikeja gra ikeja gra ikeja lagos,4,8,4,4,4,1,1,0,1,8,42000000
2212,Ikeja,ikeja gra ikeja lagos,4,8,4,4,4,0,0,0,0,8,26250000
2213,Ikeja,... opebi ikeja lagos,4,10,5,5,5,0,0,0,0,9,36750000
2214,Ikeja,ikeja lagos,4,3,2,1,2,0,0,0,0,5,8400000
2215,Ikeja,adeniyi jones ikeja lagos,4,6,3,3,3,0,0,0,1,6,15750000
2216,Ikeja," awuse estate, opebi opebi ikeja lagos",4,11,6,5,6,0,0,0,0,10,49350000
2217,Ikeja,showemimo str ikeja gra ikeja gra ikeja lagos,4,9,5,4,5,0,0,0,1,9,52500000
2218,Ikeja,akora estate adeniyi jones ikeja lagos,4,9,5,4,5,0,0,0,0,9,36750000
2219,Ikeja,allen avenue road ikeja allen avenue ikeja lagos,4,7,4,3,4,0,0,0,0,8,21000000
2220,Ikeja," salvation bus stop opebi ikeja, lagos opebi ikeja lagos",4,5,3,2,3,0,0,0,0,6,14700000
2221,Ikeja,ikeja lagos,4,2,1,1,1,1,0,0,1,2,7350000
2222,Ikeja,ikeja lagos,4,6,3,3,3,1,0,0,1,6,31500000
2223,Ikeja,ikeja lagos,4,12,6,6,6,1,1,0,1,10,65100000
2224,Ikeja,ikeja lagos,4,6,3,3,3,1,0,0,1,6,31500000
2225,Ikeja,opebi ikeja lagos,4,6,3,3,3,0,0,0,1,6,15750000
2226,Ikeja,arowojobe estate marylandland maryland ikeja lagos,4,10,5,5,5,0,0,0,0,9,36750000
2227,Ikeja,toyin street ikeja lagos,4,4,2,2,2,1,0,0,1,5,13650000
2228,Ikeja,ikeja lagos,4,2,1,1,1,1,1,1,1,2,8400000
2229,Ikeja,ikeja lagos,4,8,4,4,4,1,1,0,1,8,42000000
2230,Ikeja,ikeja lagos,4,6,3,3,3,0,0,0,1,6,21000000
2231,Ikeja,ikeja lagos,4,6,3,3,3,0,0,0,1,6,15750000
2232,Ikeja,toyin street ikeja lagos,4,6,3,3,3,0,0,0,1,6,15750000
2233,Ikeja,oregun oregun ikeja lagos,4,2,1,1,1,0,0,0,0,2,4200000
2234,Ikeja,off toyin street toyin street ikeja lagos,4,2,1,1,1,0,0,0,1,2,6825000
2235,Ikeja,adeniyi jones ikeja lagos,4,11,6,5,6,0,0,0,0,10,52500000
2236,Ikeja,ikeja lagos,4,8,4,4,4,0,0,0,1,8,31500000
2237,Ikeja,ikeja lagos,4,6,3,3,3,1,1,1,1,6,36750000
2238,Ikeja,ikeja lagos,4,6,3,3,3,1,1,1,1,6,36750000
2239,Ikeja,ikeja lagos,4,6,3,3,3,0,0,0,1,6,29400000
2240,Ikeja,ikeja lagos,4,6,3,3,3,1,1,1,1,6,36750000
2241,Ikeja,ikeja lagos,4,6,3,3,3,0,0,0,1,6,26250000
2242,Ikeja,adeniyi jones ikeja lagos,4,11,6,5,6,0,0,0,0,10,52500000
2243,Ikeja,0 ikeja gra ikeja lagos,4,13,7,6,7,1,1,0,1,10,71400000
2244,Ikeja,"shangisha phase 2, magodo, ikeja lagos",4,9,5,4,5,0,0,0,0,9,36750000
2245,Ikeja,allen allen avenue ikeja lagos,4,6,3,3,3,0,0,0,1,6,21000000
2246,Ikeja,awuse estate opebi ikeja lagos,4,9,5,4,5,0,0,0,1,9,52500000
2247,Ikeja,ikeja gra ikeja lagos,4,7,4,3,4,0,0,0,1,8,36750000
2248,Ikeja,at ikeja gra ikeja lagos,4,5,3,2,3,1,0,0,1,6,31500000
2249,Ikeja,"omole phase 2, ikeja lagos",4,11,6,5,6,0,0,0,0,10,49350000
2250,Ikeja,ikeja omole omole phase 2 ojodu lagos,4,8,4,4,4,0,0,0,0,8,21000000
2251,Ikeja,. ikeja gra ikeja lagos,4,7,4,3,4,1,1,0,1,8,42000000
2252,Ikeja,0 ikeja gra ikeja lagos,4,11,6,5,6,1,1,0,1,10,65100000
2253,Ikeja,awuse estate off opebi opebi ikeja lagos,4,7,4,3,4,0,0,0,1,8,36750000
2254,Ikeja,off isaac john street ikeja gra ikeja lagos,4,9,5,4,5,0,0,0,1,9,52500000
2255,Ikeja,. ikeja gra ikeja lagos,4,7,4,3,4,1,1,0,1,8,42000000
2256,Ikeja,adeniyi jones ikeja lagos,4,6,3,3,3,0,0,0,0,6,10500000
2257,Ikeja,0 adeniyi jones ikeja lagos,4,9,5,4,5,0,0,0,0,9,42000000
2258,Ikeja,.. opebi ikeja lagos,4,8,4,4,4,0,0,0,0,8,21000000
2259,Ikeja,mobolaji bank anthony way ikeja lagos,4,9,5,4,5,1,1,0,1,9,57750000
2260,Ikeja,1 adeniyi jones ikeja lagos,4,7,4,3,4,1,1,0,1,8,42000000
2261,Ikeja,opebi ikeja lagos,4,8,4,4,4,1,1,0,1,8,42000000
2262,Ikeja,.. awolowo way ikeja lagos,4,4,2,2,2,0,0,0,0,5,8400000
2263,Ikeja,allen avenue ikeja lagos,4,10,5,5,5,0,0,0,0,9,36750000
2264,Ikeja,ladipo bateye street ikeja gra ikeja lagos,4,8,4,4,4,1,1,0,1,8,42000000
2265,Ikeja,ikeja off awolowo way. awolowo way ikeja lagos,4,4,2,2,2,0,0,0,0,5,8400000
2266,Ikeja,mangoro ikeja lagos,4,5,3,2,3,0,0,0,0,6,11550000
2267,Ikeja,"shangisha phase 2, magodo, ikeja lagos",4,9,5,4,5,0,0,0,0,9,36750000
2268,Ikeja,opebi ikeja lagos,4,5,3,2,3,0,0,0,0,6,12600000
2269,Ikeja,at ikeja gra ikeja lagos,4,7,4,3,4,0,0,0,1,8,36750000
2270,Ikeja,awuse estate opebi ikeja lagos,4,6,3,3,3,1,0,0,1,6,31500000
2271,Ikeja,ikeja gra ikeja lagos,4,11,6,5,6,1,1,0,1,10,65100000
2272,Ikeja,awuse estate opebi ikeja lagos,4,7,4,3,4,0,0,0,0,8,21000000
2273,Ikeja,ikeja gra ikeja lagos,4,7,4,3,4,0,0,0,0,8,26250000
2274,Ikeja,- adeniyi jones ikeja lagos,4,7,6,1,6,1,1,0,1,10,65100000
2275,Ikeja,opebi ikeja lagos,4,7,4,3,4,0,0,0,0,8,21000000
2276,Ikeja,adeniyi jones ikeja lagos,4,10,5,5,5,1,1,0,1,9,57750000
2277,Ikeja,ikeja gra ikeja lagos,4,9,5,4,5,0,0,0,1,9,52500000
2278,Ikeja,ikeja gra ikeja lagos,4,9,5,4,5,1,1,0,1,9,57750000
2279,Ikeja,allen avenue ikeja lagos,4,7,4,3,4,0,0,0,0,8,29400000
2280,Ikeja,.. awolowo way ikeja lagos,4,4,2,2,2,0,0,0,1,5,10500000
2281,Ikeja,0 ikeja gra ikeja lagos,4,11,6,5,6,1,1,0,1,10,65100000
2282,Ikeja,opebi ikeja lagos,4,10,5,5,5,1,1,0,1,9,57750000
2283,Ikeja,opebi ikeja lagos,4,8,4,4,4,0,0,0,0,8,21000000
2284,Ikeja,gra ikeja lagos,4,7,4,3,4,0,0,0,0,8,21000000
2285,Ikeja,ikeja gra ikeja lagos,4,9,5,4,5,0,0,0,1,9,52500000
2286,Ikeja,0 ikeja gra ikeja lagos,4,10,5,5,5,1,1,0,1,9,57750000
2287,Ikeja,oregun ikeja lagos,4,8,4,4,4,0,0,0,0,8,21000000
2288,Ikeja," along oregun road, ikeja oregun ikeja lagos",4,10,5,5,5,1,1,0,1,9,57750000
2289,Ikeja,ikeja gra ikeja lagos,4,5,3,2,3,0,0,0,1,6,15750000
2290,Ikeja,0 ikeja gra ikeja lagos,4,9,5,4,5,0,0,0,0,9,42000000
2291,Ikeja,- adeniyi jones ikeja lagos,4,10,5,5,5,1,1,0,1,9,57750000
2292,Ikeja,allen avenue ikeja lagos,4,8,4,4,4,0,0,0,0,8,29400000
2293,Ikeja,opebi ikeja lagos,4,5,3,2,3,0,0,0,0,6,12600000
2294,Ikeja,gra ikeja gra ikeja lagos,4,7,4,3,4,1,1,0,1,8,42000000
2295,Ikeja,adeniyi jones ikeja lagos,4,9,5,4,5,0,0,0,0,9,36750000
2296,Ikeja,... opebi ikeja lagos,4,8,4,4,4,0,0,0,0,8,21000000
2297,Ikeja," unilag estate, gra, magodo ikeja lagos",4,7,4,3,4,0,0,0,0,8,21000000
2298,Ikeja,opebi ikeja lagos,4,10,5,5,5,1,1,0,1,9,57750000
2299,Ikeja,adeniyi jones ikeja lagos,4,6,3,3,3,0,0,0,0,6,10500000
2300,Ikeja,coker estate alausa ikeja lagos,4,6,3,3,3,0,0,0,1,6,21000000
2301,Ikeja,opebi ikeja lagos,4,4,2,2,2,1,1,1,1,5,16800000
2302,Ikeja,shogunle street ikeja gra ikeja lagos,4,4,2,2,2,0,0,0,0,5,8400000
2303,Ikeja,ikeja gra ikeja lagos,4,11,6,5,6,1,1,0,1,10,65100000
2304,Ikeja,allen avenue ikeja lagos,4,8,4,4,4,0,0,0,0,8,26250000
2305,Ikeja,"shangisha phase 2, gra, magodo ikeja lagos",4,7,4,3,4,0,0,0,0,8,26250000
2306,Ikeja,ikeja lagos,4,6,3,3,3,0,0,0,1,6,26250000
2307,Ikeja,mangoro ikeja lagos,4,3,2,1,2,0,0,0,0,5,8400000
2308,Ikeja,airport road airport road(ikeja) ikeja lagos,4,6,3,3,3,0,0,0,1,6,15750000
2309,Ikeja,toyin street ikeja lagos,4,2,1,1,1,0,0,0,1,2,6825000
2310,Ikeja," olowora isheri, isheri ikeja lagos",4,5,3,2,3,0,0,0,0,6,11550000
2311,Ikeja,allen avenue ikeja lagos,4,2,1,1,1,1,1,1,1,2,10500000
2312,Ikeja,opebi ikeja lagos,4,11,6,5,6,0,0,0,0,10,49350000
2313,Ikeja,ikeja gra ikeja lagos,4,8,4,4,4,1,1,0,1,8,42000000
2314,Ikeja,obafemi awolowo way ikeja lagos,4,6,3,3,3,0,0,0,0,6,13650000
2315,Ikeja,alausa ikeja lagos,4,8,4,4,4,0,0,0,0,8,21000000
2316,Ikeja," awolowo road ,ikeja awolowo way ikeja lagos",4,5,3,2,3,1,1,1,1,6,36750000
2317,Ikeja,0 ikeja gra ikeja lagos,4,9,5,4,5,1,1,0,1,9,57750000
2318,Ikeja,0 ikeja gra ikeja lagos,4,9,5,4,5,1,1,0,1,9,57750000
2319,Ikeja,0 ikeja gra ikeja lagos,4,5,3,2,3,1,1,1,1,6,36750000
2320,Ikeja,0 ikeja gra ikeja lagos,4,11,6,5,6,1,1,0,1,10,65100000
2321,Ikeja,0 ikeja gra ikeja lagos,4,7,4,3,4,1,1,0,1,8,42000000
2322,Ikeja," ikeja gra, ikeja lagos",4,7,4,3,4,0,0,0,1,8,36750000
2323,Ikeja," salvation road, omega courts, opebi ikeja lagos",4,6,3,3,3,1,0,0,1,6,33600000
2324,Ikeja,oladipupo kuku allen avenue ikeja lagos,4,8,4,4,4,0,0,0,1,8,36750000
2325,Ikeja,mangoro ikeja lagos,4,9,5,4,5,0,0,0,0,9,36750000
2326,Ikeja,0 ikeja gra ikeja lagos,4,11,6,5,6,1,1,0,1,10,65100000
2327,Ikeja,ikeja toyin street ikeja lagos,4,2,1,1,1,0,0,0,0,2,4200000
2328,Ikeja,.. opebi ikeja lagos,4,5,3,2,3,0,0,0,1,6,15750000
2329,Ikeja,off allen avenue ikeja lagos,4,7,4,3,4,0,0,0,0,8,21000000
2330,Ikeja,. ikeja gra ikeja lagos,4,5,3,2,3,1,1,1,1,6,36750000
2331,Ikeja,awuse estate opebi ikeja lagos,4,7,4,3,4,1,1,0,1,8,42000000
2332,Ikeja,0 ikeja gra ikeja lagos,4,11,6,5,6,1,1,0,1,10,65100000
2333,Ikeja,. ikeja gra ikeja lagos,4,5,3,2,3,1,1,1,1,6,36750000
2334,Ikeja,omole phase 2 ikeja lagos,4,6,3,3,3,0,0,0,1,6,21000000
2335,Ikeja,opebi ikeja lagos,4,10,5,5,5,0,0,0,0,9,36750000
2336,Ikeja,0 ikeja gra ikeja lagos,4,7,4,3,4,1,1,0,1,8,42000000
2337,Ikeja,toyin street ikeja lagos,4,10,5,5,5,0,0,0,0,9,36750000
2338,Ikeja,ikeja lagos,4,6,3,3,3,0,0,0,1,6,26250000
2339,Ikeja,1 ikeja gra ikeja lagos,4,9,5,4,5,1,1,0,1,9,57750000
2340,Ikeja,ikeja gra ikeja lagos,4,10,5,5,5,1,1,0,1,9,57750000
2341,Ikeja,alausa ikeja lagos,4,6,3,3,3,1,1,1,1,6,36750000
2342,Ikeja,0 ikeja gra ikeja lagos,4,9,5,4,5,0,0,0,1,9,52500000
2343,Ikeja,toyin street ikeja lagos,4,6,3,3,3,0,0,0,0,6,14700000
2344,Ikeja,.. adeniyi jones ikeja lagos,4,2,1,1,1,0,0,0,0,2,4200000
2345,Ikeja,- allen avenue ikeja lagos,4,6,3,3,3,1,0,0,1,6,31500000
2346,Ikeja,toyin street ikeja lagos,4,8,4,4,4,0,0,0,0,8,21000000
2347,Ikeja,akira estate adeniyi jones ikeja lagos,4,8,4,4,4,1,1,0,1,8,42000000
2348,Ikeja,adeniyi jones ikeja adeniyi jones ikeja lagos,4,2,1,1,1,0,0,0,1,2,6300000
2349,Ikeja,"51 oluwaleimu street, allen avenue allen avenue ikeja lagos",4,7,4,3,4,0,0,0,1,8,31500000
2350,Ikeja," oluwaleimu street, allen allen avenue ikeja lagos",4,7,4,3,4,0,0,0,1,8,31500000
2351,Ikeja,"51 oluwaleimu street, allen avenue allen avenue ikeja lagos",4,7,4,3,4,0,0,0,1,8,31500000
2352,Ikeja,ikeja gra ikeja lagos,4,8,4,4,4,1,1,0,1,8,42000000
2353,Ikeja,alfred gardens estate oregun ikeja lagos,4,10,5,5,5,0,0,0,1,9,52500000
2354,Ikeja," opic, isheri north, ikeja lagos",4,7,4,3,4,0,0,0,0,8,21000000
2355,Ikeja," olanrewaju street off billing sway ,oregun oregun ikeja lagos",4,3,2,1,2,0,0,0,0,5,8400000
2356,Ikeja,obawole off ogba ikeja lagos,4,6,3,3,3,0,0,0,0,6,9450000
2357,Ikeja,obawole off ogba ikeja lagos,4,6,3,3,3,0,0,0,0,6,9450000
2358,Ikeja," ikeja gra, ikeja lagos",4,9,5,4,5,1,1,0,1,9,57750000
2359,Ikeja,off allen avenue ikeja allen avenue ikeja lagos,4,4,2,2,2,1,0,0,1,5,13650000
2360,Ikeja," off ayo-alabi street oke-ira, ogba ikeja lagos",4,6,3,3,3,0,0,0,0,6,9450000
2361,Ikeja,ogba ikeja lagos,4,7,4,3,4,0,0,0,0,8,21000000
2362,Ikeja," ikeja gra, ikeja gra ikeja lagos",4,9,5,4,5,0,0,0,0,9,36750000
2363,Ikeja,millennium estate ikeja gra ikeja lagos,4,7,4,3,4,1,1,0,1,8,42000000
2364,Ikeja,off adeniyi jones . ikeja adeniyi jones ikeja lagos,4,8,4,4,4,1,1,0,1,8,42000000
2365,Ikeja,estate off adeniyi jones adeniyi jones ikeja lagos,4,11,6,5,6,1,1,0,1,10,65100000
2366,Ikeja,alfred garden oregun oregun ikeja lagos,4,6,3,3,3,1,1,1,1,6,36750000
2367,Ikeja,olaiya street alausa ikeja lagos,4,4,2,2,2,0,0,0,0,5,9450000
2368,Ikeja,adeniyi jones ikeja adeniyi jones ikeja lagos,4,7,4,3,4,0,0,0,0,8,21000000
2369,Ikeja,adeniyi jones adeniyi jones ikeja lagos,4,9,5,4,5,0,0,0,0,9,36750000
2370,Ikeja,sslvation opebi ikeja lagos,4,4,2,2,2,1,1,1,1,5,17850000
2371,Ikeja,ajisafe ikeja gra ikeja lagos,4,9,5,4,5,1,1,0,1,9,57750000
2372,Ikeja,omole phase 2 lagos ikeja lagos,4,5,3,2,3,0,0,0,0,6,11550000
2373,Ikeja,"oshorun estate, opic, isheri north content from nigeria property centre read more at: https://nigeriapropertycentre.com/for-rent/houses/detached-duplexes/lagos/isheri-north/opic/591137-top-notch-and-newly-built-4-bedroom-duplex ikeja lagos",4,9,5,4,5,0,0,0,0,9,36750000
2374,Ikeja,117 opebi road ikeja agungi lekki lagos,4,3,2,1,2,0,0,0,1,5,12600000
2375,Ikeja," magodo, gra, magodo ikeja lagos",4,6,3,3,3,0,0,0,1,6,18900000
2376,Ikeja,"otedola estate, omole phase 2, ikeja lagos",4,7,4,3,4,0,0,0,0,8,21000000
2377,Ikeja,off oduduwa way ikeja gra ikeja lagos,4,10,5,5,5,1,1,0,1,9,57750000
2378,Ikeja,omole phase 2 ikeja lagos,4,7,4,3,4,0,0,0,0,8,21000000
2379,Ikeja," salvation road after wema bank, omega courts, opebi ikeja lagos",4,10,5,5,5,0,0,0,0,9,50400000
2380,Ikeja," ikeja gra, ikeja gra ikeja lagos",4,9,5,4,5,1,1,0,1,9,57750000
2381,Ikeja,adeniyi jones adeniyi jones ikeja lagos,4,9,5,4,5,1,1,0,1,9,57750000
2382,Ikeja,7 ajisafe street ikeja g.r.a ikeja gra ikeja lagos,4,5,3,2,3,1,0,0,1,6,31500000
2383,Ikeja,8&10 shonny highway shonibare estate maryland maryland ikeja lagos,4,4,2,2,2,1,1,1,1,5,23100000
2384,Ikeja,adeniyi jones ikeja lagos,4,7,4,3,4,0,0,0,0,8,21000000
2385,Ikeja,isaac john ikeja gra ikeja lagos,4,2,1,1,1,1,1,1,1,2,10500000
2386,Ikeja,ikeja gra ikeja gra ikeja lagos,4,5,3,2,3,1,1,1,1,6,36750000
2387,Ikeja,oladipo bateye street ikeja gra ikeja lagos,4,9,5,4,5,0,0,0,1,9,52500000
2388,Ikeja,off allen allen avenue ikeja lagos,4,7,4,3,4,1,1,0,1,8,42000000
2389,Ikeja,oba ladejobi ikeja gra ikeja lagos,4,12,6,6,6,1,1,0,1,10,65100000
2390,Ikeja,"24 oba akinjobi way, ikeja, gra, lagos, ikeja gra, ikeja, lagos ikeja gra ikeja lagos",4,5,3,2,3,1,1,1,1,6,36750000
2391,Ikeja,opebi road ikeja opebi ikeja lagos,4,7,4,3,4,0,0,0,0,8,21000000
2392,Ikeja," shonny str, shonibare estate maryland ikeja mobolaji bank anthony way ikeja lagos",4,8,5,3,5,0,0,0,0,9,36750000
2393,Ikeja,shonibare estate mobolaji bank anthony way ikeja lagos,4,11,6,5,6,0,0,0,0,10,49350000
2394,Ikeja,orileyimu str off allen allen avenue ikeja lagos,4,2,1,1,1,0,0,0,0,2,4725000
2395,Ikeja," emeka anyaoku millennium estate, muiz banire street, ikeja gra ikeja gra ikeja lagos",4,9,5,4,5,0,0,0,0,9,36750000
2396,Ikeja," afariogun street, off awolowo way, ikeja, lagos obafemi awolowo way ikeja lagos",4,4,2,2,2,0,0,0,0,5,8400000
2397,Iyana Ipaja,peace est aboru iyana ipaja lagos pipeline alimosho lagos,5,7,4,3,4,0,0,0,0,3,5250000
2398,Iyana Ipaja,an estate inside aboru iyana ipaja lagos alimosho lagos,5,6,3,3,3,0,0,0,1,2,5250000
2399,Iyana Ipaja,t alimosho lagos,5,4,2,2,2,0,0,0,0,1,2625000
2400,Iyana Ipaja,hilltop estate iyana ipaja lagos pipeline alimosho lagos,5,4,2,2,2,0,0,0,1,1,4200000
2401,Iyana Ipaja,peace avenue evergreen est aboru iyana ipaja lagos alimosho lagos,5,6,3,3,3,0,0,0,0,2,4200000
2402,Iyana Ipaja,iyana ipaja ipaja lagos,5,5,3,2,3,1,1,0,1,2,5775000
2403,Iyana Ipaja,prime garden estate aboru iyana ipaja ipaja lagos,5,6,3,3,3,1,1,0,1,2,5775000
2404,Iyana Ipaja,iyana paja road iyana ipaja ipaja lagos,5,8,4,4,4,1,1,0,1,3,6825000
2405,Iyana Ipaja,prime garden estate iyana paja iyana ipaja ipaja lagos,5,8,4,4,4,0,0,0,0,3,5250000
2406,Iyana Ipaja," command, ikola road. iyana ipaja ipaja lagos",5,5,3,2,3,0,0,0,0,2,4200000
2407,Iyana Ipaja,pleasure iyana ipaja ipaja lagos,5,6,3,3,3,0,0,0,1,2,5250000
2408,Iyana Ipaja,aboru iyana ipaja ipaja lagos,5,6,3,3,3,0,0,0,1,2,5250000
2409,Iyana Ipaja,iyana ipaja aboru egbeda alimosho lagos,5,2,1,1,1,0,0,0,1,1,1575000
2410,Iyana Ipaja,ishola okosule inside aboru iyana ipaja lagos pipeline alimosho lagos,5,2,1,1,1,0,0,0,0,1,945000
2411,Iyana Ipaja,iyana ipaja aboru egbeda alimosho lagos,5,2,1,1,1,0,0,0,1,1,1575000
2412,Iyana Ipaja,iyana ipaja aboru egbeda alimosho lagos,5,6,3,3,3,0,0,0,0,2,3150000
2413,Iyana Ipaja,governors road alimosho iyana-ipaja extension egbeda alimosho lagos,5,2,1,1,1,1,1,1,1,1,2625000
2414,Iyana Ipaja,hitop estate alimosho iyana-ipaja extension egbeda alimosho lagos,5,2,1,1,1,0,0,0,1,1,1575000
2415,Iyana Ipaja,iyana ipaja ipaja lagos,5,4,2,2,2,0,0,0,0,1,3150000
2416,Iyana Ipaja,iyana ipaja ipaja lagos,5,4,2,2,2,0,0,0,1,1,4200000
2417,Iyana Ipaja,aboru iyana ipaja ipaja lagos,5,4,2,2,2,1,1,0,1,1,5250000
2418,Iyana Ipaja,iyana ipaja ipaja lagos,5,7,4,3,4,1,1,0,1,3,6825000
2419,Iyana Ipaja,iyana ipaja ipaja lagos,5,4,2,2,2,0,0,0,0,1,3675000
2420,Iyana Ipaja,iyana ipaja ipaja lagos,5,4,2,2,2,1,1,1,1,1,5775000
2421,Iyana Ipaja,iyana ipaja ipaja lagos,5,4,2,2,2,0,0,0,1,1,4200000
2422,Iyana Ipaja,iyana ipaja ipaja lagos,5,4,2,2,2,1,1,0,1,1,5250000
2423,Iyana Ipaja,hiltop estate iyana ipaja lagos alimosho lagos,5,4,2,2,2,0,0,0,1,1,4725000
2424,Iyana Ipaja,pipeline alimosho lagos,5,7,4,3,4,1,1,0,1,3,6825000
2425,Iyana Ipaja,iyana ipaja ipaja lagos,5,4,2,2,2,1,1,1,1,1,5775000
2426,Iyana Ipaja,orile agege agege lagos,5,9,5,4,5,1,1,0,1,5,12600000
2427,Iyana Ipaja,prime estate iyana ipaja ipaja lagos,5,6,3,3,3,1,1,1,1,2,6825000
2428,Iyana Ipaja," prime garden estate,aboru iyana ipaja . alimosho lagos",5,7,4,3,4,1,1,0,1,3,6825000
2429,Iyana Ipaja,an estate inside aboru iyana ipaja alimosho lagos,5,6,3,3,3,0,0,0,1,2,5250000
2430,Iyana Ipaja,hilltop estate iyana ipaja lagos alimosho lagos,5,4,2,2,2,0,0,0,1,1,4200000
2431,Iyana Ipaja,"plot 350, wilson emelike street, hilltop estate aboru, iyana-ipaja egbeda alimosho lagos",5,2,1,1,1,1,1,1,1,1,3150000
2432,Yaba,adekunle yaba lagos,6,7,4,3,4,1,0,0,1,6,18900000
2433,Yaba,onike yaba lagos,6,9,5,4,5,0,0,0,1,8,31500000
2434,Yaba,adekunle yaba lagos,6,2,1,1,1,0,0,0,0,2,3675094.5
2435,Yaba,moore road sabo yaba lagos,6,7,4,3,4,1,1,1,1,6,26250000
2436,Yaba,borno way adekunle yaba lagos,6,16,8,8,8,1,1,0,1,9,42000000
2437,Yaba,carter adekunle yaba lagos,6,7,4,3,4,1,0,0,1,6,18900000
2438,Yaba,brown akoka yaba lagos,6,5,3,2,3,0,0,0,1,5,12600000
2439,Yaba,zanzi estate yaba lagos,6,7,4,3,4,0,0,0,1,6,15750000
2440,Yaba,ogungbamila akoka yaba lagos,6,2,1,1,1,1,0,0,1,2,5250000
2441,Yaba,"  morroco, waec area. yaba lagos",6,6,3,3,3,0,0,0,1,5,10500000
2442,Yaba,"  folaagoro road, yaba, lagos. fola agoro yaba lagos",6,11,6,5,6,1,1,0,1,8,31500000
2443,Yaba,queens street alagomeji yaba lagos,6,6,3,3,3,1,1,1,1,5,18900000
2444,Yaba,in a secute & gated estate in yaba. yaba lagos,6,8,4,4,4,0,0,0,1,6,15750000
2445,Yaba,"  off commercial avenue, sabo, yaba. sabo yaba lagos",6,7,4,3,4,1,0,0,1,6,18900000
2446,Yaba,"  off queens street, alagomeji, yaba alagomeji yaba lagos",6,6,3,3,3,1,1,1,1,5,18900000
2447,Yaba,"  in a serene & gated estate in onike, yaba. onike yaba lagos",6,9,5,4,5,0,0,0,0,8,21000000
2448,Yaba,"  commercial avenue, sabo, yaba. sabo yaba lagos",6,7,4,3,4,1,1,1,1,6,26250000
2449,Yaba,"  off commercial avenue, sabo, yaba. sabo yaba lagos",6,5,3,2,3,1,1,1,1,5,15750000
2450,Yaba,"  off hebert macaulay way, alagomeji, yaba. alagomeji yaba lagos",6,6,3,3,3,1,1,1,1,5,15750000
2451,Yaba,"  off hebert macaulay way, adekunle, yaba. adekunle yaba lagos",6,7,4,3,4,0,0,0,0,6,13650000
2452,Yaba,in a serene & gated estate onike yaba lagos,6,7,4,3,4,0,0,0,0,6,13650000
2453,Yaba,"  olonade street, alagomeji, yaba. alagomeji yaba lagos",6,7,4,3,4,0,0,0,1,6,15750000
2454,Yaba,off onike roundabout onike yaba lagos,6,6,3,3,3,1,0,0,1,5,13650000
2455,Yaba,sabo yaba lagos,6,8,4,4,4,0,0,0,0,6,14700000
2456,Yaba,akoka yaba lagos,6,2,1,1,1,1,1,1,1,2,6300000
2457,Yaba,sabo yaba sabo yaba lagos,6,9,5,4,5,0,0,0,0,8,26250000
2458,Yaba,queen street alagomeji yaba lagos,6,2,1,1,1,1,1,1,1,2,6300000
2459,Yaba,ozone sabo yaba lagos,6,6,3,3,3,1,1,1,1,5,15750000
2460,Yaba,in an estate onike yaba lagos,6,7,4,3,4,0,0,0,1,6,15750000
2461,Yaba,off fola agoro abule ijesha yaba lagos,6,4,2,2,2,0,0,0,1,3,7350000
2462,Yaba,off chemist busstop akoka yaba lagos,6,7,4,3,4,0,0,0,0,6,12600000
2463,Yaba,onike onike yaba lagos,6,7,4,3,4,0,0,0,1,6,15750000
2464,Yaba,off pako busstop akoka yaba lagos,6,2,1,1,1,1,1,1,1,2,6300000
2465,Yaba,akoka yaba lagos,6,2,1,1,1,0,0,0,0,2,4200000
2466,Yaba,off herbert macaulay ebute metta yaba lagos,6,2,1,1,1,1,0,0,1,2,5250000
2467,Yaba,sabo yaba lagos,6,2,1,1,1,0,0,0,0,2,3150000
2468,Yaba,fola agoro road fola agoro yaba lagos,6,11,6,5,6,1,1,0,1,8,31500000
2469,Yaba,silvercrest estate onike yaba lagos,6,10,5,5,5,1,0,0,1,8,33600000
2470,Yaba,off herbert macaulay way yaba lagos,6,7,4,3,4,1,0,0,1,6,18900000
2471,Yaba,chemist area akoka yaba lagos,6,2,1,1,1,1,0,0,1,2,5250000
2472,Yaba,sabo yaba lagos,6,9,5,4,5,0,0,0,1,8,31500000
2473,Yaba,bickersteth estate onike yaba lagos,6,9,5,4,5,0,0,0,0,8,21000000
2474,Yaba,tejuosho tejuosho yaba lagos,6,4,2,2,2,0,0,0,1,3,7350000
2475,Yaba,akoka yaba lagos,6,4,2,2,2,0,0,0,1,3,7350000
2476,Yaba,ebute metta yaba lagos,6,6,3,3,3,0,0,0,1,5,12600000
2477,Yaba,tejuosho yaba lagos,6,2,1,1,1,0,0,0,0,2,4200000
2478,Yaba,ozone environment sabo yaba lagos,6,7,4,3,4,1,1,1,1,6,21000000
2479,Yaba,heliconia court jibowu yaba lagos,6,7,4,3,4,1,1,1,1,6,26250000
2480,Yaba,.. adekunle yaba lagos,6,8,4,4,4,1,1,1,1,6,21000000
2481,Yaba,off onike roundabout onike yaba lagos,6,4,2,2,2,1,1,0,1,3,8925000
2482,Yaba,roundabout onike yaba lagos,6,2,1,1,1,0,0,0,0,2,3150000
2483,Yaba,monsuro abule oja yaba lagos,6,2,1,1,1,0,0,0,0,2,3990000
2484,Yaba,adekunle street adekunle yaba lagos,6,4,2,2,2,0,0,0,0,3,5250000
2485,Yaba,close to costain ebute metta yaba lagos,6,6,3,3,3,0,0,0,0,5,8400000
2486,Yaba,off herbert macaulay way alagomeji yaba lagos,6,4,2,2,2,1,0,0,1,3,8400000
2487,Yaba,off queens street alagomeji yaba lagos,6,2,1,1,1,0,0,0,0,2,4200000
2488,Yaba,akoka yaba lagos,6,2,1,1,1,1,1,1,1,2,6300000
2489,Yaba,onike yaba lagos,6,2,1,1,1,1,0,0,1,2,5250000
2490,Yaba,yaba adekunle yaba lagos,6,2,1,1,1,0,0,0,0,2,3675000
2491,Yaba,off fola agoro road yaba lagos yaba lagos,6,7,3,4,3,0,0,0,1,5,10500000
2492,Yaba,akoka akoka yaba lagos,6,2,1,1,1,1,0,0,1,2,5250000
2493,Yaba,adekule adekunle yaba lagos,6,2,1,1,1,0,0,0,0,2,3675000
2494,Yaba,onike yaba lagos,6,7,4,3,4,0,0,0,1,6,15750000
2495,Yaba,onike yaba lagos,6,7,4,3,4,0,0,0,1,6,15750000
2496,Yaba,adekunle yaba lagos,6,7,4,3,4,1,0,0,1,6,18900000
2497,Yaba,akoka yaba lagos,6,4,2,2,2,0,0,0,1,3,7350000
2498,Yaba,.. akoka yaba lagos,6,5,3,2,3,0,0,0,0,5,9450000
2499,Yaba,akoka yaba lagos,6,2,1,1,1,1,1,1,1,2,6300000
2500,Yaba,onike yaba lagos,6,4,2,2,2,1,1,0,1,3,8925000
2501,Yaba,ebute meta east ebute metta yaba lagos,6,7,4,3,4,0,0,0,0,6,12600000
2502,Yaba,morocco yaba lagos,6,6,3,3,3,0,0,0,1,5,10500000
2503,Yaba,off cemetery road ebute metta yaba lagos,6,5,3,2,3,0,0,0,0,5,8400000
2504,Yaba,morocco yaba lagos,6,6,3,3,3,0,0,0,1,5,10500000
2505,Yaba,ebute meta east ebute metta yaba lagos,6,2,1,1,1,0,0,0,0,2,3675000
2506,Yaba,helliconia court yaba gra yaba lagos,6,9,5,4,5,1,0,0,1,8,33600000
2507,Yaba,ebute meta ebute metta yaba lagos,6,5,3,2,3,0,0,0,1,5,10500000
2508,Yaba,ebute meta west ebute metta yaba lagos,6,5,3,2,3,0,0,0,1,5,10500000
2509,Yaba,morocco yaba lagos,6,4,2,2,2,0,0,0,1,3,7350000
2510,Yaba,off herbert marcaulay way alagomeji yaba alagomeji yaba lagos,6,7,4,3,4,0,0,0,1,6,15750000
2511,Yaba,alagomeji alagomeji yaba lagos,6,7,4,3,4,1,1,1,1,6,21000000
2512,Yaba,old yaba road adekunle yaba lagos,6,3,2,1,2,1,0,0,1,3,8400000
2513,Yaba,- ebute metta yaba lagos,6,4,2,2,2,0,0,0,1,3,7350000
2514,Yaba,behind yabatech yaba lagos,6,5,3,2,3,0,0,0,1,5,12600000
2515,Yaba,adekunle yaba lagos,6,7,4,3,4,1,0,0,1,6,18900000
2516,Yaba,... akoka yaba lagos,6,7,4,3,4,0,0,0,1,6,15750000
2517,Yaba,clegg yaba lagos,6,2,1,1,1,0,0,0,0,2,4200000
2518,Yaba,.. adekunle yaba lagos,6,7,4,3,4,1,1,1,1,6,21000000
2519,Yaba," off community road, akoka very close to bariga , akoka yaba lagos",6,6,3,3,3,0,0,0,0,5,7350000
2520,Yaba,akoka yaba lagos,6,2,1,1,1,1,0,0,1,2,5250000
2521,Yaba,onike akoka yaba lagos,6,2,1,1,1,0,0,0,0,2,4200000
2522,Yaba,onike akoka yaba lagos,6,2,1,1,1,1,1,1,1,2,6300000
2523,Yaba,akoka akoka yaba lagos,6,7,4,3,4,0,0,0,0,6,10500000
2524,Yaba,fola agoro yaba lagos,6,5,3,2,3,0,0,0,1,5,10500000
2525,Yaba,in a serene & gated estate sabo yaba lagos,6,4,2,2,2,1,1,0,1,3,8925000
2526,Yaba,onike yaba lagos,6,7,4,3,4,0,0,0,0,6,13650000
2527,Yaba,akoka yaba lagos,6,2,1,1,1,1,0,0,1,2,5250000
2528,Yaba," aderupoko street, iwaya iwaya yaba lagos",6,2,1,1,1,0,0,0,0,2,3150000
2529,Yaba,sabo yaba lagos,6,8,4,4,4,0,0,0,1,6,16800000
2530,Yaba,yaba lagos,6,2,1,1,1,0,0,0,0,2,3675000
2531,Yaba,akoka akoka yaba lagos,6,4,2,2,2,0,0,0,0,3,6825000
2532,Yaba,akoka yaba akoka yaba lagos,6,6,3,3,3,0,0,0,1,5,12600000
2533,Yaba,abule ijesha yaba abule ijesha yaba lagos,6,6,3,3,3,0,0,0,1,5,10500000
2534,Yaba,abule ijesha yaba abule ijesha yaba lagos,6,6,3,3,3,0,0,0,1,5,10500000
2535,Yaba,onike yaba onike yaba lagos,6,6,3,3,3,1,0,0,1,5,13650000
2536,Yaba,onike sabo yaba onike yaba lagos,6,6,3,3,3,1,0,0,1,5,13650000
2537,Yaba,onike sabo onike yaba lagos,6,6,3,3,3,1,0,0,1,5,13650000
2538,Yaba,yaba lagos,6,4,2,2,2,1,1,1,1,3,13650000
2539,Yaba,sabo yaba lagos,6,2,1,1,1,0,0,0,0,2,4200000
2540,Yaba,onike yaba lagos,6,2,1,1,1,1,0,0,1,2,5250000
2541,Yaba,onike yaba lagos,6,2,1,1,1,1,0,0,1,2,5250000
2542,Yaba,fola agoro yaba lagos,6,2,1,1,1,0,0,0,1,2,4725000
2543,Yaba,akoka yaba lagos,6,3,2,1,2,0,0,0,1,3,7350000
2544,Yaba,onike yaba lagos,6,2,1,1,1,1,0,0,1,2,5250000
2545,Yaba,onike yaba lagos,6,2,1,1,1,1,0,0,1,2,5250000
2546,Yaba,onike yaba lagos,6,2,1,1,1,1,0,0,1,2,5250000
2547,Yaba,yaba alagomeji yaba lagos,6,2,1,1,1,1,1,1,1,2,6300000
2548,Yaba,akoka yaba lagos,6,4,2,2,2,0,0,0,1,3,7350000
2549,Yaba,akoka yaba lagos,6,2,1,1,1,1,0,0,1,2,5250000
2550,Yaba,abule nla ebute metta yaba lagos,6,5,3,2,3,0,0,0,1,5,10500000
2551,Yaba,onike yaba lagos,6,4,2,2,2,1,1,0,1,3,8925000
2552,Yaba,sabo yaba lagos,6,9,5,4,5,0,0,0,1,8,31500000
2553,Yaba,close to adekunle ebute metta yaba lagos,6,2,1,1,1,0,0,0,0,2,3675000
2554,Yaba,sabo sabo yaba lagos,6,9,5,4,5,1,1,0,1,8,36750000
2555,Yaba,yaba lagos,6,2,1,1,1,0,0,0,0,2,3150000
2556,Yaba,fola agoro fola agoro yaba lagos,6,7,4,3,4,1,0,0,1,6,18900000
2557,Yaba,akoka yaba lagos,6,2,1,1,1,1,1,1,1,2,6300000
2558,Yaba,fola agoro yaba lagos,6,4,2,2,2,1,1,1,1,3,13650000
2559,Yaba,.. akoka yaba lagos,6,7,4,3,4,0,0,0,1,6,15750000
2560,Yaba,akoka yaba lagos,6,2,1,1,1,1,0,0,1,2,5250000
2561,Yaba,onike yaba lagos,6,2,1,1,1,0,0,0,1,2,4725000
2562,Yaba,iwaya yaba lagos,6,6,3,3,3,0,0,0,0,5,7350000
2563,Yaba,ebute metta yaba lagos,6,4,2,2,2,1,0,0,1,3,8400000
2564,Yaba,fola agoro yaba lagos,6,2,1,1,1,1,1,1,1,2,6300000
2565,Yaba,off fola-agoro yaba lagos yaba lagos,6,2,1,1,1,0,0,0,1,2,4725000
2566,Yaba,close to pako bus stop akoka yaba lagos,6,7,4,3,4,0,0,0,1,6,15750000
2567,Yaba,morrocco axis jibowu yaba lagos,6,6,3,3,3,0,0,0,1,5,10500000
2568,Yaba,onike onike yaba lagos,6,2,1,1,1,0,0,0,0,2,4200000
2569,Yaba,sabo yaba lagos,6,5,3,2,3,1,1,1,1,5,15750000
2570,Yaba,a very clean 2br apartment at akoka extension 2t2b good packing space 550k akoka yaba lagos,6,4,2,2,2,0,0,0,0,3,5775000
2571,Yaba,tejuosho yaba lagos,6,4,2,2,2,0,0,0,0,3,5250000
2572,Yaba,chemist akoka yaba lagos,6,2,1,1,1,0,0,0,0,2,3675000
2573,Yaba,awofala street akoka yaba lagos,6,6,3,3,3,0,0,0,0,5,7350000
2574,Yaba,off bornu way adekunle yaba lagos,6,6,3,3,3,1,1,1,1,5,18900000
2575,Yaba,close to pako bus stop akoka yaba lagos,6,2,1,1,1,0,0,0,0,2,4200000
2576,Yaba,off fola-agoro yaba lagos yaba lagos,6,2,1,1,1,0,0,0,1,2,4725000
2577,Yaba,fola agoro yaba lagos,6,2,1,1,1,0,0,0,0,2,3150000
2578,Yaba,- ebute metta yaba lagos,6,4,2,2,2,0,0,0,0,3,6300000
2579,Yaba,alagomeji yaba lagos,6,6,3,3,3,1,1,1,1,5,18900000
2580,Yaba,.. onike yaba lagos,6,2,1,1,1,0,0,0,0,2,4200000
2581,Yaba," ebute meta west,. lagos state ebute metta yaba lagos",6,6,3,3,3,0,0,0,0,5,9450000
2582,Yaba,akoka akoka yaba lagos,6,7,4,3,4,0,0,0,0,6,10500000
2583,Yaba,akoka yaba lagos,6,5,3,2,3,0,0,0,0,5,8400000
2584,Yaba,close to pako bus stop akoka yaba lagos,6,7,4,3,4,0,0,0,1,6,15750000
2585,Yaba," ebute metta east, ebute metta yaba lagos",6,2,1,1,1,0,0,0,0,2,3150000
2586,Yaba,alagomeji yaba lagos,6,8,4,4,4,1,1,1,1,6,21000000
2587,Yaba,close to adekunle ebute metta yaba lagos,6,6,3,3,3,1,0,0,1,5,13650000
2588,Yaba,ebute metta yaba lagos,6,4,2,2,2,0,0,0,0,3,5250000
2589,Yaba,abule oja yaba lagos,6,2,1,1,1,0,0,0,0,2,3990000
2590,Yaba,moore road sabo yaba lagos,6,2,1,1,1,0,0,0,0,2,4200000
2591,Yaba,isaac john jibowu yaba lagos,6,6,3,3,3,0,0,0,1,5,13125000
2592,Yaba,davies abule oja yaba lagos,6,2,1,1,1,1,0,1,1,2,5775000
2593,Yaba,close to pako bus stop akoka yaba lagos,6,2,1,1,1,0,0,0,0,2,4200000
2594,Yaba,akoka yaba lagos,6,7,4,3,4,0,0,0,0,6,12600000
2595,Yaba,alagomeji alagomeji yaba lagos,6,7,4,3,4,1,1,1,1,6,21000000
2596,Yaba,abule ijesha yaba lagos,6,2,1,1,1,0,0,0,0,2,4200000
2597,Yaba,onike yaba lagos,6,2,1,1,1,0,0,0,1,2,4725000
2598,Yaba,moore road sabo yaba lagos,6,2,1,1,1,0,0,0,0,2,4200000
2599,Yaba,off akoka akoka yaba lagos,6,2,1,1,1,0,0,0,0,2,3150000
2600,Yaba,abudu abule oja yaba lagos,6,2,1,1,1,0,0,0,0,2,4200000
2601,Yaba,off akoka akoka yaba lagos,6,2,1,1,1,0,0,0,0,2,3150000
2602,Yaba,.. sabo yaba lagos,6,7,4,3,4,0,0,0,0,6,10500000
2603,Yaba,zanzi street onike yaba lagos,6,2,1,1,1,0,0,0,0,2,3150000
2604,Yaba,fola agoro yaba fola agoro yaba lagos,6,5,3,2,3,0,0,0,0,5,9450000
2605,Yaba,- fola agoro yaba lagos,6,6,3,3,3,0,0,0,1,5,10500000
2606,Yaba,jibowu yaba lagos,6,3,1,2,1,1,1,1,1,2,6300000
2607,Yaba,akoka yaba lagos,6,2,1,1,1,1,1,1,1,2,6300000
2608,Yaba,yaba lagos,6,2,1,1,1,0,0,0,0,2,3150000
2609,Yaba,alara street onike yaba lagos,6,2,1,1,1,1,1,1,1,2,6300000
2610,Yaba,yaba lagos,6,6,3,3,3,1,1,1,1,5,18900000
2611,Yaba,onike yaba lagos,6,2,1,1,1,0,0,0,1,2,4725000
2612,Yaba,akoka yaba lagos,6,7,4,3,4,0,0,0,0,6,12600000
2613,Yaba,- onike yaba lagos,6,2,1,1,1,0,0,0,0,2,4200000
2614,Yaba,yaba lagos,6,6,3,3,3,1,0,0,1,5,13650000
2615,Yaba,moroko yaba lagos,6,2,1,1,1,0,0,0,0,2,3675000
2616,Yaba,yaba lagos,6,6,3,3,3,1,1,1,1,5,15750000
2617,Yaba,fola agoro yaba lagos,6,2,1,1,1,1,1,1,1,2,6300000
2618,Yaba,onike yaba lagos,6,2,1,1,1,0,0,0,1,2,4725000
2619,Yaba,ojuelegba axis tejuosho yaba lagos,6,2,1,1,1,0,0,0,0,2,4200000
2620,Yaba,.. fola agoro yaba lagos,6,6,3,3,3,1,1,1,1,5,18900000
2621,Yaba,onike onike yaba lagos,6,3,1,2,1,1,1,1,1,2,6300000
2622,Yaba,akoka yaba lagos,6,4,2,2,2,1,0,0,1,3,8400000
2623,Yaba,akoka /bariga area akoka yaba lagos,6,5,3,2,3,0,0,0,0,5,7350000
2624,Yaba,close to pako bus stop akoka yaba lagos,6,2,1,1,1,1,1,1,1,2,6300000
2625,Yaba,fola agoro yaba lagos,6,4,2,2,2,1,0,0,1,3,8400000
2626,Yaba,off akoka akoka yaba lagos,6,6,3,3,3,0,0,0,0,5,7350000
2627,Yaba,- iwaya yaba lagos,6,6,3,3,3,0,0,0,0,5,8400000
2628,Yaba,jibowu yaba lagos,6,4,2,2,2,1,1,1,1,3,13650000
2629,Yaba,harbert macaulay by jebba yaba lagos,6,2,1,1,1,0,0,0,0,2,3675000
2630,Yaba,ebutte metta ebute metta yaba lagos,6,4,2,2,2,1,1,1,1,3,10500000
2631,Yaba,akoka yaba lagos,6,6,3,3,3,0,0,0,1,5,10500000
2632,Yaba,yaba ebute east side. ebute metta yaba lagos,6,7,4,3,4,0,0,0,0,6,13650000
2633,Yaba,akoka akoka yaba lagos,6,2,1,1,1,1,0,0,1,2,5250000
2634,Yaba,close to pako bus stop akoka yaba lagos,6,2,1,1,1,1,1,1,1,2,6300000
2635,Yaba,onike yaba lagos,6,2,1,1,1,0,0,0,1,2,4725000
2636,Yaba,alagomeji yaba lagos,6,7,4,3,4,0,0,0,1,6,15750000
2637,Yaba,.. ebute metta yaba lagos,6,5,3,2,3,0,0,0,0,5,7350000
2638,Yaba," along unilag road, yaba lagos abule oja yaba lagos",6,2,1,1,1,0,0,0,0,2,4200000
2639,Yaba,adekunle yaba lagos,6,2,1,1,1,0,0,0,0,2,3675000
2640,Yaba,- onike yaba lagos,6,6,3,3,3,1,0,0,1,5,13650000
2641,Yaba,fola agoro yaba lagos,6,2,1,1,1,0,0,0,1,2,4725000
2642,Yaba,old yaba road adekunle yaba lagos,6,7,4,3,4,1,0,0,1,6,18900000
2643,Yaba,onike yaba lagos,6,3,2,1,2,0,0,0,0,3,6300000
2644,Yaba,akoka yaba lagos,6,4,2,2,2,0,0,0,0,3,6300000
2645,Yaba,yaba lagos,6,2,1,1,1,0,0,0,0,2,3150000
2646,Yaba,alagomeji yaba lagos,6,4,2,2,2,1,0,0,1,3,8400000
2647,Yaba,onike yaba lagos,6,2,1,1,1,0,0,0,1,2,4725000
2648,Yaba,yaba lagos,6,2,1,1,1,1,0,0,1,2,5250000
2649,Yaba,akoka akoka yaba lagos,6,2,1,1,1,1,0,0,1,2,5250000
2650,Yaba,adekunle adekunle yaba lagos,6,6,3,3,3,1,1,1,1,5,18900000
2651,Yaba,akoka akoka yaba lagos,6,2,1,1,1,1,0,0,1,2,5250000
2652,Yaba,beside ilaje police station akoka yaba lagos,6,2,1,1,1,0,0,0,0,2,3150000
2653,Yaba,- akoka yaba lagos,6,3,2,1,2,0,0,0,0,3,5250000
2654,Yaba,akoka yaba lagos,6,5,3,2,3,0,0,0,0,5,7350000
2655,Yaba,yaba lagos,6,4,2,2,2,1,1,1,1,3,9450000
2656,Yaba," royal estate connal road, alagomeji yaba lagos",6,8,4,4,4,1,1,1,1,6,26250000
2657,Yaba,onike yaba lagos,6,2,1,1,1,1,1,1,1,2,6300000
2658,Yaba,- sabo yaba lagos,6,4,2,2,2,1,1,1,1,3,13650000
2659,Yaba,adekunle yaba adekunle yaba lagos,6,7,4,3,4,1,0,0,1,6,18900000
2660,Yaba,close to pako bus stop akoka yaba lagos,6,2,1,1,1,0,0,0,0,2,4200000
2661,Yaba,brown street akoka yaba lagos,6,6,3,3,3,0,0,0,1,5,12600000
2662,Yaba,adekunle yaba lagos,6,6,3,3,3,0,0,0,1,5,10500000
2663,Yaba,akoka yaba lagos,6,5,3,2,3,0,0,0,0,5,9450000
2664,Yaba,- alagomeji yaba lagos,6,5,3,2,3,0,0,0,0,5,8400000
2665,Yaba,fola agoro fola agoro yaba lagos,6,7,4,3,4,1,0,0,1,6,18900000
2666,Yaba,adekunle yaba lagos,6,7,4,3,4,1,0,0,1,6,18900000
2667,Yaba,onike yaba lagos,6,2,1,1,1,0,0,0,0,2,4200000
2668,Yaba,akoka yaba lagos,6,4,2,2,2,0,0,0,1,3,7350000
2669,Yaba,yaba lagos,6,2,1,1,1,1,1,1,1,2,6300000
2670,Yaba,yaba lagos,6,2,1,1,1,1,1,1,1,2,6300000
2671,Yaba,yaba lagos,6,8,4,4,4,1,1,1,1,6,26250000
2672,Yaba,yaba lagos,6,2,1,1,1,1,0,0,1,2,5250000
2673,Yaba,sabo yaba lagos,6,4,2,2,2,0,0,0,1,3,7350000
2674,Yaba,johnson onike yaba lagos,6,4,2,2,2,1,0,0,1,3,8400000
2675,Yaba,- jibowu yaba lagos,6,3,2,1,2,0,0,0,0,3,5250000
2676,Yaba,akoka yaba lagos,6,2,1,1,1,1,0,0,1,2,5250000
2677,Yaba,fola agoro yaba lagos,6,3,2,1,2,0,0,0,0,3,6300000
2678,Yaba,onike yaba lagos,6,2,1,1,1,0,0,0,1,2,4725000
2679,Yaba,fola agoro yaba lagos,6,5,3,2,3,0,0,0,0,5,9450000
2680,Yaba,jibowu yaba lagos,6,4,2,2,2,1,0,0,1,3,8400000
2681,Yaba,akoka akoka yaba lagos,6,4,2,2,2,0,0,0,1,3,7350000
2682,Yaba,em akoka yaba lagos,6,2,1,1,1,0,0,0,0,2,4200000
2683,Yaba,emily akoka yaba lagos,6,2,1,1,1,1,1,1,1,2,6300000
2684,Yaba," adjacent unilag,not far from hebert macaulay expressway akoka yaba lagos",6,4,2,2,2,0,0,0,0,3,5250000
2685,Yaba,off tejuosho road tejuosho yaba lagos,6,2,1,1,1,1,0,0,1,2,5250000
2686,Yaba,adjacent unilag akoka yaba lagos,6,2,1,1,1,1,1,1,1,2,6300000
2687,Yaba," grace court estate, off herbert macaulay way, adekunle yaba lagos",6,9,5,4,5,1,1,0,1,8,36750000
2688,Yaba,makoko adekunle yaba lagos,6,2,1,1,1,0,0,0,0,2,3990000
2689,Yaba,akoka yaba lagos,6,2,1,1,1,1,0,1,1,2,5775000
2690,Yaba,onike yaba lagos,6,2,1,1,1,1,1,1,1,2,6300000
2691,Yaba,fola agoro fola agoro yaba lagos,6,2,1,1,1,0,0,0,0,2,3675000
2692,Yaba," akoka, akoka, akoka yaba lagos",6,2,1,1,1,0,0,0,0,2,3150000
2693,Yaba,western avenue by surulere jibowu yaba lagos,6,2,1,1,1,0,0,0,1,2,4725000
2694,Yaba,off iwaya road iwaya yaba lagos,6,4,2,2,2,1,0,0,1,3,8400000
2695,Yaba,akoka yaba lagos,6,7,4,3,4,0,0,0,0,6,13650000
2696,Yaba,akoka yaba lagos,6,7,4,3,4,0,0,0,1,6,15750000
2697,Gbagada,millenuim ups gbagada lagos,7,7,4,3,4,0,0,0,1,7,24150000
2698,Gbagada,phase 2 gbagada lagos,7,9,5,4,5,1,1,0,1,8,31500000
2699,Gbagada,... millenuim ups gbagada lagos,7,7,4,3,4,1,1,0,1,7,26250000
2700,Gbagada,millenuim ups gbagada lagos,7,7,4,3,4,0,0,0,1,7,24150000
2701,Gbagada,... millenuim ups gbagada lagos,7,7,4,3,4,1,1,0,1,7,26250000
2702,Gbagada,ifako gbagada gbagada lagos,7,6,3,3,3,1,1,1,1,5,14700000
2703,Gbagada,millenuim ups gbagada lagos,7,7,4,3,4,1,1,0,1,7,26250000
2704,Gbagada,... millenuim ups gbagada lagos,7,5,3,2,3,1,1,1,1,5,18900000
2705,Gbagada,glory estate ifako gbagada gbagada lagos,7,7,4,3,4,1,1,0,1,7,26250000
2706,Gbagada,off ifako ifako gbagada gbagada lagos,7,4,2,2,2,0,0,0,0,3,7350000
2707,Gbagada,power line soluyi gbagada lagos,7,6,3,3,3,0,0,0,0,5,8925000
2708,Gbagada,ifako josland area ifako gbagada gbagada lagos,7,5,3,2,3,0,0,0,0,5,7875000
2709,Gbagada,sosanya soluyi gbagada lagos,7,5,3,2,3,0,0,0,0,5,8925000
2710,Gbagada,millenuim ups gbagada lagos,7,2,1,1,1,1,1,1,1,2,6825000
2711,Gbagada,medina gbagada lagos,7,7,4,3,4,0,0,0,0,7,15750000
2712,Gbagada,alapere gbagada lagos,7,4,2,2,2,0,0,0,0,3,6300000
2713,Gbagada,phase 2 gbagada lagos,7,7,4,3,4,0,0,0,0,7,15750000
2714,Gbagada,ifako ifako gbagada gbagada lagos,7,5,3,2,3,0,0,0,1,5,10500000
2715,Gbagada,ifako gbagada gbagada lagos,7,4,2,2,2,0,0,0,1,3,8400000
2716,Gbagada,millenuim ups gbagada lagos,7,7,4,3,4,0,0,0,1,7,18900000
2717,Gbagada,soluyi gbagada lagos,7,2,1,1,1,0,0,0,1,2,4725000
2718,Gbagada,pedro-gbagada area gbagada lagos,7,5,3,2,3,1,1,0,1,5,13650000
2719,Gbagada,odo-eran iyana orowo gbagada oworonshoki gbagada lagos,7,5,3,2,3,0,0,0,0,5,7350000
2720,Gbagada,after deperlife church gbagada lagos,7,2,1,1,1,0,0,0,1,2,4725000
2721,Gbagada,sawmill gbagada gbagada lagos,7,5,3,2,3,0,0,0,0,5,9450000
2722,Gbagada,off pedro gbagada ifako gbagada gbagada lagos,7,5,3,2,3,0,0,0,1,5,10500000
2723,Gbagada,"  community street ,odo eran,iyana oworo gbagada lagos",7,2,1,1,1,0,0,0,0,2,4200000
2724,Gbagada,gb millenuim ups gbagada lagos,7,7,4,3,4,1,1,0,1,7,26250000
2725,Gbagada,pedro phase 1 gbagada lagos,7,6,3,3,3,0,0,0,0,5,8925000
2726,Gbagada,ifako gbagada gbagada lagos,7,5,3,2,3,0,0,0,1,5,10500000
2727,Gbagada,ifako gbagada gbagada lagos,7,7,4,3,4,0,0,0,0,7,13650000
2728,Gbagada,atunrase medina gbagada lagos,7,7,4,3,4,0,0,0,1,7,21000000
2729,Gbagada,ifako gbagada gbagada lagos,7,5,3,2,3,1,1,1,1,5,15750000
2730,Gbagada,millenuim ups gbagada lagos,7,7,4,3,4,0,0,0,0,7,16800000
2731,Gbagada,millenuim ups gbagada lagos,7,7,4,3,4,0,0,0,1,7,21000000
2732,Gbagada,ifako ifako gbagada gbagada lagos,7,7,4,3,4,0,0,0,1,7,21000000
2733,Gbagada,ferano court ifako gbagada gbagada lagos,7,11,6,5,6,1,1,0,1,8,31500000
2734,Gbagada,millennium estate millenuim ups gbagada lagos,7,7,4,3,4,1,1,0,1,7,26250000
2735,Gbagada,millennium estate millenuim ups gbagada lagos,7,9,5,4,5,1,1,1,1,8,36750000
2736,Gbagada,josodat estate soluyi gbagada lagos,7,7,4,3,4,0,0,0,0,7,15750000
2737,Gbagada,ifako gbagada gbagada lagos,7,6,3,3,3,0,0,0,1,5,10500000
2738,Gbagada,medina gbagada lagos,7,5,2,3,2,1,1,1,1,3,13650000
2739,Gbagada,soluyi gbagada lagos,7,6,3,3,3,0,0,0,0,5,7350000
2740,Gbagada,ifako gbagada gbagada lagos,7,6,3,3,3,0,0,0,0,5,9450000
2741,Gbagada,akinwunmi ifako gbagada gbagada lagos,7,4,2,2,2,0,0,0,0,3,7350000
2742,Gbagada,ifako gbagada gbagada lagos,7,6,3,3,3,1,1,0,1,5,13650000
2743,Gbagada,.. ifako gbagada gbagada lagos,7,6,3,3,3,0,0,0,0,5,8400000
2744,Gbagada,soluyi gbagada lagos,7,6,3,3,3,0,0,0,0,5,7350000
2745,Gbagada,gbagada road phase 2 gbagada lagos,7,2,1,1,1,1,1,0,1,2,5250000
2746,Gbagada,popoola soluyi gbagada lagos,7,6,3,3,3,1,0,0,1,5,12600000
2747,Gbagada,yetunde brown ifako gbagada gbagada lagos,7,4,2,2,2,0,0,0,1,3,8400000
2748,Gbagada,medina gbagada lagos,7,6,3,3,3,1,1,0,1,5,13650000
2749,Gbagada,sawmill ifako gbagada gbagada lagos,7,7,4,3,4,0,0,0,0,7,11550000
2750,Gbagada,gbagada lagos,7,4,2,2,2,0,0,0,0,3,7350000
2751,Gbagada,soluyi gbagada lagos,7,6,3,3,3,0,0,0,0,5,9450000
2752,Gbagada,ifako gbagada gbagada lagos,7,6,3,3,3,0,0,0,1,5,10500000
2753,Gbagada,millennium estate millenuim ups gbagada lagos,7,7,4,3,4,1,1,0,1,7,26250000
2754,Gbagada,medina gbagada lagos,7,5,3,2,3,0,0,0,0,5,8400000
2755,Gbagada,pedro phase 1 gbagada lagos,7,8,4,4,4,0,0,0,1,7,21000000
2756,Gbagada,gbagada extension ifako gbagada gbagada lagos,7,2,1,1,1,1,1,0,1,2,5250000
2757,Gbagada,soluyi gbagada lagos,7,2,1,1,1,0,0,0,1,2,4725000
2758,Gbagada,around mobil phase 2 gbagada lagos,7,3,2,1,2,0,0,0,0,3,6825000
2759,Gbagada,soluyi gbagada lagos,7,2,1,1,1,0,0,0,1,2,4725000
2760,Gbagada,medina gbagada lagos,7,4,2,2,2,0,0,0,1,3,8400000
2761,Gbagada,millenuim ups gbagada lagos,7,8,4,4,4,1,1,0,1,7,26250000
2762,Gbagada,millennium estate ups gbagada millenuim ups gbagada lagos,7,7,4,3,4,0,0,0,0,7,15750000
2763,Gbagada,soluyi gbagada lagos,7,6,3,3,3,1,0,0,1,5,12600000
2764,Gbagada,- ifako gbagada gbagada lagos,7,4,2,2,2,1,0,0,1,3,9450000
2765,Gbagada,off ajayi aina in a close ifako gbagada gbagada lagos,7,7,4,3,4,0,0,0,0,7,15750000
2766,Gbagada,soluyi gbagada lagos,7,5,3,2,3,0,0,0,0,5,9450000
2767,Gbagada,ifako gbagada gbagada lagos,7,2,1,1,1,0,0,0,1,2,4725000
2768,Gbagada,oke alo millenuim ups gbagada lagos,7,7,4,3,4,1,1,0,1,7,26250000
2769,Gbagada,soluyi gbagada lagos,7,2,1,1,1,1,1,0,1,2,5250000
2770,Gbagada,millenuim ups gbagada lagos,7,7,4,3,4,1,1,0,1,7,26250000
2771,Gbagada,millenuim ups gbagada lagos,7,7,4,3,4,1,1,0,1,7,26250000
2772,Gbagada,millenuim ups gbagada lagos,7,8,4,4,4,1,1,0,1,7,26250000
2773,Gbagada,ifako gbagada gbagada lagos,7,6,3,3,3,0,0,0,1,5,10500000
2774,Gbagada,ifako gbagada gbagada lagos,7,6,3,3,3,0,0,0,1,5,10500000
2775,Gbagada,millennium estate gbagada millenuim ups gbagada lagos,7,7,4,3,4,1,1,0,1,7,26250000
2776,Gbagada,power line soluyi gbagada lagos,7,5,3,2,3,0,0,0,0,5,7350000
2777,Gbagada," off labake street, mayaki oworo, gbagada oworonshoki gbagada lagos",7,2,1,1,1,0,0,0,0,2,3150000
2778,Gbagada,off dehinde estate ifako gbagada ifako gbagada gbagada lagos,7,4,2,2,2,0,0,0,0,3,5250000
2779,Gbagada," off secretariat street, oworosoki, gbagada oworonshoki gbagada lagos",7,4,2,2,2,0,0,0,0,3,5250000
2780,Gbagada," off labake street, oworosoki, gbagada, lagos oworonshoki gbagada lagos",7,2,1,1,1,0,0,0,0,2,3150000
2781,Gbagada,oke alo millenuim ups gbagada lagos,7,7,4,3,4,0,0,0,0,7,15750000
2782,Gbagada,oworonshoki gbagada lagos,7,7,4,3,4,0,0,0,0,7,10500000
2783,Gbagada,ifako gbagada ifako gbagada gbagada lagos,7,7,4,3,4,0,0,0,0,7,13650000
2784,Gbagada,gbagada phase one extension phase 1 gbagada lagos,7,5,3,2,3,0,0,0,1,5,10500000
2785,Gbagada,chevron soluyi gbagada lagos,7,7,4,3,4,0,0,0,0,7,12600000
2786,Gbagada,- gbagada lagos,7,2,1,1,1,1,1,1,1,2,7350000
2787,Gbagada,glory estate ifako gbagada gbagada lagos,7,7,4,3,4,1,1,0,1,7,26250000
2788,Gbagada,- gbagada lagos,7,3,2,1,2,0,0,0,1,3,8400000
2789,Gbagada,medina gbagada lagos,7,5,3,2,3,0,0,0,0,5,8400000
2790,Gbagada,medina estate gbagada medina gbagada lagos,7,9,5,4,5,0,0,0,0,8,26250000
2791,Gbagada,oke alo millennium estate gbagada millenuim ups gbagada lagos,7,7,4,3,4,1,1,0,1,7,26250000
2792,Gbagada,shadia estate soluyi gbagada lagos,7,4,2,2,2,1,1,1,1,3,10500000
2793,Gbagada,medina gbagada lagos,7,5,3,2,3,0,0,0,1,5,10500000
2794,Gbagada," off williams street, gbagada ifako gbagada gbagada lagos",7,6,3,3,3,0,0,0,0,5,9450000
2795,Gbagada,atunrase atunrase medina gbagada lagos,7,5,3,2,3,0,0,0,1,5,10500000
2796,Gbagada,sawmill ifako gbagada gbagada lagos,7,7,4,3,4,0,0,0,0,7,12600000
2797,Gbagada,pefro gbagada lagos,7,6,4,2,4,0,0,0,0,7,12600000
2798,Gbagada,millenuim ups gbagada lagos,7,7,4,3,4,1,1,0,1,7,26250000
2799,Gbagada,josadat estate soluyi gbagada lagos,7,7,4,3,4,0,0,0,0,7,15750000
2800,Gbagada,gbagada lagos,7,6,4,2,4,1,1,0,1,7,26250000
2801,Gbagada,phase 2 gbagada lagos,7,9,5,4,5,1,1,0,1,8,31500000
2802,Gbagada," off secretariat, street, oworosoki, gbagada oworonshoki gbagada lagos",7,4,2,2,2,0,0,0,0,3,5250000
2803,Gbagada,peace estate soluyi gbagada lagos,7,2,1,1,1,0,0,0,0,2,4200000
2804,Gbagada," off zainab crescent, medina estate gbagada atunrase medina gbagada lagos",7,7,4,3,4,0,0,0,0,7,16800000
2805,Gbagada,millennium estate gbagada millenuim ups gbagada lagos,7,8,5,3,5,0,0,0,0,8,28350000
2806,Gbagada,glory estate ifako gbagada gbagada lagos,7,7,4,3,4,0,0,0,1,7,21000000
2807,Gbagada,powerline soluyi gbagada soluyi gbagada lagos,7,5,3,2,3,0,0,0,0,5,7350000
2808,Gbagada," off adio street, gbagada, newgarage, gbagada lagos new garage gbagada lagos",7,7,4,3,4,0,0,0,0,7,10500000
2809,Gbagada,ifako gbagada gbagada lagos,7,5,3,2,3,0,0,0,1,5,10500000
2810,Gbagada,soluyi gbagada lagos,7,5,3,2,3,0,0,0,1,5,10500000
2811,Gbagada,ifako gbagada gbagada lagos,7,5,3,2,3,0,0,0,1,5,10500000
2812,Gbagada,soluyi gbagada lagos,7,7,4,3,4,0,0,0,0,7,12600000
2813,Gbagada,medina medina gbagada lagos,7,6,3,3,3,1,1,1,1,5,15750000
2814,Gbagada,sholuyi soluyi gbagada lagos,7,4,2,2,2,0,0,0,0,3,7350000
2815,Gbagada,gbagada road phase 2 gbagada lagos,7,2,1,1,1,1,1,0,1,2,5250000
2816,Gbagada,poopola soluyi gbagada lagos,7,2,1,1,1,0,0,0,1,2,4725000
2817,Gbagada,millenuim ups gbagada lagos,7,5,3,2,3,1,1,1,1,5,18900000
2818,Gbagada,soluyi gbagada lagos,7,5,3,2,3,0,0,0,0,5,7350000
2819,Gbagada,phase 2 gbagada lagos,7,2,1,1,1,1,1,0,1,2,5250000
2820,Gbagada,soluyi gbagada lagos,7,5,3,2,3,0,0,0,0,5,7350000
2821,Gbagada,gbagada lagos,7,8,4,4,4,0,0,0,0,7,15750000
2822,Gbagada," millennium estate, millenuim ups gbagada lagos",7,7,4,3,4,0,0,0,0,7,15750000
2823,Gbagada,gbagada lagos,7,6,3,3,3,0,0,0,0,5,7350000
2824,Gbagada,gbagada lagos,7,2,1,1,1,0,0,0,1,2,4725000
2825,Gbagada,gbagada lagos,7,6,3,3,3,1,1,1,1,5,15750000
2826,Gbagada,charlie boy axis gbagada lagos,7,2,1,1,1,1,1,0,1,2,5250000
2827,Gbagada,gbagada lagos,7,6,3,3,3,1,0,0,1,5,12600000
2828,Gbagada,soluyi gbagada lagos,7,4,2,2,2,0,0,0,0,3,7350000
2829,Gbagada,medina gbagada lagos,7,5,3,2,3,0,0,0,0,5,8400000
2830,Gbagada,gbagada phase 2 phase 2 gbagada lagos,7,2,1,1,1,1,1,0,1,2,5250000
2831,Gbagada,yetunde brown ifako gbagada gbagada lagos,7,2,1,1,1,1,1,0,1,2,5250000
2832,Gbagada,ifako gbagada gbagada lagos,7,2,1,1,1,0,0,0,1,2,4725000
2833,Gbagada,phase 2 gbagada lagos,7,7,4,3,4,0,0,0,0,7,10500000
2834,Gbagada,estaport avenue soluyi gbagada lagos,7,2,1,1,1,1,1,0,1,2,5250000
2835,Gbagada,josodat estate soluyi gbagada lagos,7,10,5,5,5,0,0,0,0,8,26250000
2836,Gbagada,soluyi gbagada lagos,7,8,4,4,4,0,0,0,0,7,15750000
2837,Gbagada,soluyi gbagada lagos,7,6,3,3,3,1,0,0,1,5,12600000
2838,Gbagada,jimoh bajulaye ifako gbagada gbagada lagos,7,6,3,3,3,1,0,0,1,5,12600000
2839,Gbagada,phase 2 gbagada lagos,7,9,5,4,5,1,1,0,1,8,31500000
2840,Gbagada,akinwunmi street ifako gbagada gbagada lagos,7,3,2,1,2,0,0,0,0,3,5250000
2841,Gbagada,ester port avenue soluyi gbagada lagos,7,2,1,1,1,1,1,0,1,2,5250000
2842,Gbagada,soluyi gbagada lagos,7,5,3,2,3,0,0,0,0,5,7350000
2843,Gbagada,millenuim ups gbagada lagos,7,6,3,3,3,1,1,1,1,5,15750000
2844,Gbagada,gbagada ifako gbagada gbagada lagos,7,2,1,1,1,1,1,1,1,2,7350000
2845,Gbagada,soluyi gbagada lagos,7,6,3,3,3,0,0,0,0,5,7350000
2846,Gbagada,.. soluyi gbagada lagos,7,2,1,1,1,0,0,0,0,2,4200000
2847,Gbagada,phase 1 gbagada lagos,7,4,2,2,2,1,1,1,1,3,12600000
2848,Gbagada,.. phase 2 gbagada lagos,7,5,3,2,3,0,0,0,1,5,10500000
2849,Gbagada,soluyi soluyi gbagada lagos,7,5,3,2,3,0,0,0,0,5,7350000
2850,Gbagada,.. ifako gbagada gbagada lagos,7,6,3,3,3,0,0,0,0,5,9450000
2851,Gbagada,new garage gbagada lagos,7,4,2,2,2,0,0,0,1,3,7875000
2852,Gbagada,millennium estate gbagada millenuim ups gbagada lagos,7,7,4,3,4,1,1,0,1,7,26250000
2853,Gbagada,- phase 1 gbagada lagos,7,7,4,3,4,0,0,0,0,7,10500000
2854,Gbagada,estate medina gbagada lagos,7,2,1,1,1,0,0,0,0,2,3150000
2855,Gbagada,millenuim ups gbagada lagos,7,7,4,3,4,1,1,0,1,7,26250000
2856,Gbagada,gbagada oke alo lagos. ifako gbagada gbagada lagos,7,6,3,3,3,1,1,1,1,5,18900000
2857,Gbagada,atiku street soluyi gbagada lagos,7,4,2,2,2,0,0,0,0,3,6825000
2858,Gbagada,medina gbagada lagos,7,5,3,2,3,0,0,0,1,5,10500000
2859,Gbagada,yetunde brown ifako gbagada gbagada lagos,7,5,3,2,3,0,0,0,1,5,11550000
2860,Gbagada,deeper life axis ifako gbagada gbagada lagos,7,4,2,2,2,0,0,0,0,3,5775000
2861,Gbagada,millenuim ups gbagada lagos,7,7,4,3,4,0,0,0,0,7,15750000
2862,Gbagada,new garage new garage gbagada lagos,7,5,3,2,3,0,0,0,0,5,7875000
2863,Gbagada,soluyi gbagada lagos,7,5,3,2,3,0,0,0,0,5,7350000
2864,Gbagada,after powerline bus stop soluyi gbagada lagos,7,5,3,2,3,0,0,0,0,5,7350000
2865,Gbagada,atunrase medina gbagada lagos,7,4,2,2,2,1,1,1,1,3,10500000
2866,Gbagada,millenuim ups gbagada lagos,7,6,3,3,3,1,1,1,1,5,15750000
2867,Gbagada,millennium estate millenuim ups gbagada lagos,7,7,4,3,4,0,0,0,0,7,15750000
2868,Gbagada,phase 1 gbagada lagos,7,6,3,3,3,0,0,0,1,5,10500000
2869,Gbagada,millenuim ups gbagada lagos,7,6,3,3,3,1,1,1,1,5,15750000
2870,Gbagada,gbagada phase 1 gbagada lagos,7,2,1,1,1,1,1,1,1,2,6300000
2871,Gbagada,phase 2 gbagada lagos,7,5,3,2,3,1,1,0,1,5,13650000
2872,Gbagada,phase 2 gbagada lagos,7,8,4,4,4,1,1,0,1,7,26250000
2873,Gbagada,ifako ifako gbagada gbagada lagos,7,8,4,4,4,1,1,0,1,7,26250000
2874,Gbagada,harmony estate ifako gbagada gbagada lagos,7,7,4,3,4,0,0,0,0,7,13650000
2875,Gbagada,ogundele street ifako gbagada gbagada lagos,7,7,4,3,4,0,0,0,0,7,12600000
2876,Gbagada,odo eran iyana oworo gbagada oworonshoki gbagada lagos,7,2,1,1,1,0,0,0,0,2,4200000
2877,Gbagada,phase 1 gbagada lagos,7,5,3,2,3,0,0,0,1,5,10500000
2878,Gbagada,new garage gbagada lagos,7,5,3,2,3,0,0,0,0,5,8925000
2879,Gbagada,extension phase 2 gbagada lagos,7,6,3,3,3,1,0,0,1,5,12600000
2880,Gbagada,millenuim ups gbagada lagos,7,7,4,3,4,1,1,0,1,7,26250000
2881,Gbagada,sholuyi gbagada soluyi gbagada lagos,7,6,3,3,3,1,0,0,1,5,12600000
2882,Gbagada,phase 2 gbagada lagos,7,4,2,2,2,0,0,0,0,3,6825000
2883,Gbagada,millenuim ups gbagada lagos,7,6,3,3,3,1,1,1,1,5,15750000
2884,Gbagada,millenuim ups gbagada lagos,7,7,4,3,4,1,1,0,1,7,26250000
2885,Gbagada,medina gbagada lagos,7,2,1,1,1,0,0,0,0,2,3150000
2886,Gbagada,new garage gbagada lagos,7,2,1,1,1,1,1,1,1,2,5775000
2887,Gbagada,sawmill gbagada lagos,7,4,2,2,2,1,0,0,1,3,9450000
2888,Gbagada,chevron road soluyi gbagada lagos,7,5,3,2,3,0,0,0,1,5,10500000
2889,Gbagada,yetunde brown ifako gbagada gbagada lagos,7,7,4,3,4,0,0,0,0,7,10500000
2890,Gbagada,soluyi gbagada lagos,7,2,1,1,1,0,0,0,0,2,3150000
2891,Gbagada,jesus street ifako gbagada gbagada lagos,7,7,4,3,4,0,0,0,0,7,12600000
2892,Gbagada,soluyi gbagada lagos,7,7,4,3,4,0,0,0,0,7,12600000
2893,Gbagada,soluyi soluyi gbagada lagos,7,5,3,2,3,0,0,0,0,5,7350000
2894,Gbagada,gbagada lagos,7,6,3,3,3,1,0,0,1,5,12600000
2895,Gbagada,taodak estate ifako gbagada gbagada lagos,7,5,3,2,3,0,0,0,0,5,8400000
2896,Gbagada,williams street gbagada ifako gbagada gbagada lagos,7,5,3,2,3,0,0,0,0,5,7350000
2897,Gbagada,gbagada ph2 estate. phase 2 gbagada lagos,7,9,5,4,5,1,1,0,1,8,31500000
2898,Gbagada,ifako gbagada ifako gbagada gbagada lagos,7,11,5,6,5,0,0,0,0,8,26250000
2899,Gbagada,sawmill ifako ifako gbagada gbagada lagos,7,2,1,1,1,0,0,0,0,2,3150000
2900,Gbagada,ifako gbagada gbagada lagos,7,5,3,2,3,0,0,0,1,5,10500000
2901,Gbagada,peace estate soluyi gbagada lagos,7,5,3,2,3,0,0,0,0,5,8925000
2902,Gbagada,gbagada lagos,7,5,2,3,2,1,1,1,1,3,15750000
2903,Gbagada,deeper life church road soluyi gbagada lagos,7,2,1,1,1,0,0,0,0,2,3150000
2904,Gbagada,extension phase 2 gbagada lagos,7,4,2,2,2,1,1,1,1,3,10500000
2905,Gbagada,new garage new garage gbagada lagos,7,5,3,2,3,0,0,0,0,5,7875000
2906,Gbagada,... soluyi gbagada lagos,7,5,3,2,3,1,1,0,1,5,13650000
2907,Gbagada,millenuim ups gbagada lagos,7,6,3,3,3,1,1,1,1,5,15750000
2908,Gbagada,close to uba in ifako gbagada ifako gbagada gbagada lagos,7,6,3,3,3,1,1,0,1,5,13650000
2909,Gbagada,yetunde brown ifako gbagada gbagada lagos,7,7,4,3,4,0,0,0,0,7,11550000
2910,Gbagada,gbagada lagos,7,6,3,3,3,1,1,1,1,5,15750000
2911,Gbagada,gbagada lagos,7,6,3,3,3,1,1,1,1,5,18900000
2912,Gbagada,ifako gbagada gbagada lagos,7,6,3,3,3,0,0,0,0,5,9450000
2913,Gbagada,sawmill ifako gbagada gbagada lagos,7,7,4,3,4,0,0,0,0,7,10500000
2914,Gbagada,ajayi aina ifako gbagada gbagada lagos,7,6,3,3,3,1,1,1,1,5,15750000
2915,Gbagada,atunrase medina gbagada lagos,7,5,3,2,3,0,0,0,1,5,11550000
2916,Gbagada,jimoh bajulaye ifako gbagada gbagada lagos,7,6,3,3,3,1,0,0,1,5,12600000
2917,Gbagada,phase 2 gbagada lagos,7,7,4,3,4,0,0,0,0,7,15750000
2918,Gbagada,soluyi gbagada lagos,7,7,4,3,4,0,0,0,0,7,12600000
2919,Gbagada,millenuim ups gbagada lagos,7,8,4,4,4,1,1,0,1,7,26250000
2920,Gbagada,sawmill gbagada ifako gbagada gbagada lagos,7,4,2,2,2,0,0,0,1,3,8400000
2921,Gbagada,.. ifako gbagada gbagada lagos,7,7,4,3,4,1,1,0,1,7,26250000
2922,Gbagada,new garage gbagada lagos,7,5,3,2,3,0,0,0,0,5,7875000
2923,Gbagada,deeper life axis ifako gbagada gbagada lagos,7,2,1,1,1,0,0,0,0,2,3675000
2924,Gbagada,millennium estate millenuim ups gbagada lagos,7,5,3,2,3,1,1,1,1,5,18900000
2925,Gbagada,.. atunrase medina gbagada lagos,7,6,3,3,3,0,0,0,1,5,10500000
2926,Gbagada,okealo millennium estate ifako gbagada gbagada lagos,7,6,3,3,3,1,1,1,1,5,18900000
2927,Gbagada," millennium estate, oke-alo, gbagada lagos",7,8,4,4,4,1,1,0,1,7,26250000
2928,Gbagada,soluyi gbagada lagos,7,7,4,3,4,0,0,0,0,7,12600000
2929,Gbagada,gbagada oworoshoki junction oworonshoki gbagada lagos,7,5,3,2,3,0,0,0,0,5,7350000
2930,Gbagada,medina estate medina gbagada lagos,7,7,4,3,4,0,0,0,0,7,15750000
2931,Gbagada,millenuim ups gbagada lagos,7,7,4,3,4,1,1,0,1,7,26250000
2932,Gbagada,phase 2 gbagada lagos,7,10,5,5,5,1,1,0,1,8,31500000
2933,Gbagada,gbagada lagos,7,5,3,2,3,0,0,0,0,5,7350000
2934,Gbagada,soluyi gbagada lagos,7,5,3,2,3,0,0,0,0,5,7875000
2935,Gbagada,odo eran iyana oworo gbagada oworonshoki gbagada lagos,7,5,3,2,3,0,0,0,0,5,7350000
2936,Gbagada,... millenuim ups gbagada lagos,7,7,4,3,4,1,1,0,1,7,26250000
2937,Gbagada,hu medina gbagada lagos,7,5,3,2,3,0,0,0,0,5,8400000
2938,Gbagada,hu phase 2 gbagada lagos,7,6,3,3,3,0,0,0,0,5,9450000
2939,Gbagada,oworonshoki gbagada lagos,7,2,1,1,1,0,0,0,0,2,3150000
2940,Gbagada,millenuim ups gbagada lagos,7,6,3,3,3,0,0,0,1,5,10500000
2941,Gbagada,glory estate ifako gbagada gbagada lagos,7,7,4,3,4,0,0,0,1,7,21000000
2942,Gbagada,lagos ifako gbagada gbagada lagos,7,6,3,3,3,0,0,0,1,5,10500000
2943,Gbagada,estate atunrase medina gbagada lagos,7,6,3,3,3,0,0,0,1,5,10500000
2944,Gbagada,soluyi gbagada lagos,7,2,1,1,1,0,0,0,0,2,3675000
2945,Gbagada,peace estate soluyi gbagada lagos,7,2,1,1,1,0,0,0,0,2,3150000
2946,Gbagada,peace estate soluyi gbagada lagos,7,2,1,1,1,0,0,0,0,2,3150000
2947,Gbagada,off miyaki street oworonshoki gbagada lagos,7,3,2,1,2,0,0,0,0,3,5250000
2948,Gbagada,soluyi gbagada lagos,7,2,1,1,1,0,0,0,0,2,3150000
2949,Gbagada,jimoh oladenhinde gbagada lagos,7,3,2,1,2,1,1,1,1,3,11550000
2950,Gbagada,peace estate sholuyi gbagada ifako gbagada gbagada lagos,7,7,4,3,4,0,0,0,0,7,15750000
2951,Gbagada,adeyeye street millenuim ups gbagada lagos,7,6,3,3,3,1,1,1,1,5,18900000
2952,Gbagada,oworonshoki gbagada lagos,7,2,1,1,1,0,0,0,0,2,3675000
2953,Ikorodu,beach road ebute ikorodu lagos,8,7,4,3,4,1,1,1,1,3,7875000
2954,Ikorodu,lowa estate jumofak ikorodu lagos,8,5,3,2,3,0,0,0,1,1,3675000
2955,Ikorodu,alogba estate ebute ikorodu lagos,8,7,4,3,4,0,0,0,1,3,6300000
2956,Ikorodu,"  kingsway estate, isawo agric ikorodu lagos",8,4,2,2,2,0,0,0,0,1,1785000
2957,Ikorodu,"  nasfat, isawo ikorodu ikorodu lagos",8,4,2,2,2,0,0,0,0,1,2415000
2958,Ikorodu,"  odunlami, isawo agric ikorodu lagos",8,2,1,1,1,1,1,0,1,1,1575000
2959,Ikorodu,"  kingsway estate, isawo agric agric ikorodu lagos",8,4,2,2,2,0,0,0,0,1,1890000
2960,Ikorodu,isawo isawo ikorodu lagos,8,7,4,3,4,0,0,0,0,3,4200000
2961,Ikorodu,ikorodu road(ilupeju) ilupeju lagos,8,2,1,1,1,1,1,1,1,1,3150000
2962,Ikorodu,ibeshe ibeshe ikorodu lagos,8,7,4,3,4,1,0,0,1,3,7350000
2963,Ikorodu,valley view estate ebute ikorodu lagos,8,7,4,3,4,0,0,0,1,3,6300000
2964,Ikorodu,grammar school ota ona ikorodu ikorodu lagos,8,5,3,2,3,0,0,0,0,1,2100000
2965,Ikorodu,valley view estate ebute ikorodu lagos,8,4,2,2,2,1,1,1,1,1,4200000
2966,Ikorodu,ebute ebute ikorodu lagos,8,3,2,1,2,0,0,0,1,1,2625000
2967,Ikorodu,isawo isawo ikorodu lagos,8,5,3,2,3,0,0,0,0,1,2100000
2968,Ikorodu,oba olaide estate ibeshe ikorodu lagos,8,4,2,2,2,1,0,1,1,1,3675000
2969,Ikorodu,elepe royal estate aga ebute ikorodu lagos,8,5,3,2,3,1,1,1,1,1,6300000
2970,Ikorodu,alogba estate ebute ikorodu lagos,8,4,2,2,2,1,0,1,1,1,3675000
2971,Ikorodu,ibeshe road ebute ikorodu lagos,8,5,3,2,3,1,1,1,1,1,6825000
2972,Ikorodu,isawo isawo ikorodu lagos,8,3,2,1,2,0,0,0,0,1,1050000
2973,Ikorodu,mowo kekere road ijede ikorodu lagos,8,2,1,1,1,1,1,0,1,1,1575000
2974,Ikorodu,lowa estate jumofak ikorodu lagos,8,5,3,2,3,1,0,0,1,1,4200000
2975,Ikorodu,dele kuti ebute ikorodu lagos,8,4,2,2,2,1,1,1,1,1,4200000
2976,Ikorodu,alogba estate ebute ikorodu lagos,8,5,3,2,3,1,1,1,1,1,5250000
2977,Ikorodu,beach road ebute ikorodu lagos,8,5,3,2,3,1,1,1,1,1,6300000
2978,Ikorodu,ibeshe road ebute ikorodu lagos,8,4,2,2,2,0,0,0,1,1,2625000
2979,Ikorodu,elepe royal estate aga ebute ikorodu lagos,8,5,3,2,3,1,1,1,1,1,6825000
2980,Ikorodu,olayinka jumbo ebute ikorodu lagos,8,9,5,4,5,1,1,0,1,4,8400000
2981,Ikorodu,"12 japheth omojuwa street, rabaka bus stop off. ibeshe ikorodu lagos",8,6,3,3,3,0,0,0,0,1,2835000
2982,Ikorodu,ijede road ijede ikorodu lagos,8,2,1,1,1,0,0,0,0,1,892500
2983,Ikorodu,teachers quarters igbogbo ikorodu lagos,8,6,3,3,3,0,0,0,1,1,3675000
2984,Ikorodu," cele-gbaga area, itamaga ikorodu lagos",8,4,2,2,2,0,0,0,1,1,2625000
2985,Ikorodu,awesu bus stop igbogbo ikorodu lagos,8,7,4,3,4,0,0,0,0,3,4200000
2986,Ikorodu,by abuja bus stop off ibeshe road immediately after lagoon view estate agbowa ibeshe ikorodu lagos,8,5,3,2,3,1,0,1,1,1,4725000
2987,Ikorodu,oba laide estate off ibeshe road ibeshe ikorodu lagos,8,4,2,2,2,1,1,1,1,1,4725000
2988,Ikorodu,igbogbo ikorodu lagos,8,4,2,2,2,0,0,0,1,1,3150000
2989,Ikorodu,ikorodu lagos,8,5,3,2,3,0,0,0,1,1,3675000
2990,Ikorodu,erunwe/radio area ikorodu ikorodu lagos,8,8,4,4,4,0,0,0,1,3,6300000
2991,Ikorodu,ikorodu lagos,8,5,3,2,3,0,0,0,0,1,2625000
2992,Ikorodu,ikorodu lagos,8,6,3,3,3,1,0,0,1,1,4200000
2993,Ikorodu,ikorodu lagos,8,2,1,1,1,0,0,0,1,1,1260000
2994,Ikorodu,ikorodu lagos,8,2,1,1,1,1,1,1,1,1,2100000
2995,Ikorodu,ikorodu lagos,8,4,2,2,2,0,0,0,0,1,2310000
2996,Ikorodu,ikorodu lagos,8,4,2,2,2,0,0,0,1,1,2625000
2997,Ikorodu,ikorodu lagos,8,6,3,3,3,0,0,0,0,1,3150000
2998,Ikorodu,ikorodu lagos,8,4,2,2,2,0,0,0,1,1,2625000
2999,Ikorodu,chris kpapovwe street igbogbo ikorodu lagos,8,2,1,1,1,1,1,1,1,1,2100000
3000,Ikorodu,ikorodu garage ikorodu ikorodu lagos,8,2,1,1,1,0,0,0,0,1,1155000
3001,Ikorodu,unity bus stop igbogbo ikorodu lagos,8,5,3,2,3,0,0,0,0,1,2625000
3002,Ikorodu,ikorodu lagos,8,4,2,2,2,1,0,0,1,1,3465000
3003,Ikorodu,unity first gate igbogbo ikorodu lagos,8,2,1,1,1,0,0,0,1,1,1365000
3004,Ikorodu,ikorodu lagos,8,4,2,2,2,1,1,1,1,1,6300000
3005,Ikorodu,ikorodu lagos,8,2,1,1,1,1,1,1,1,1,2310000
3006,Ikorodu,ikorodu lagos,8,2,1,1,1,1,1,1,1,1,2310000
3007,Ikorodu,agunfoye last bus stop igbogbo ikorodu lagos,8,2,1,1,1,0,0,0,1,1,1260000
3008,Ikorodu,ikorodu lagos,8,4,2,2,2,0,0,0,1,1,2625000
3009,Ikorodu," korperate,macaulay igbogbo ikorodu lagos",8,2,1,1,1,0,0,0,0,1,1050000
3010,Ikorodu,maternity area igbogbo ikorodu lagos,8,5,3,2,3,0,0,0,0,1,2100000
3011,Ikorodu,lfi igbogbo ikorodu lagos,8,4,2,2,2,0,0,0,0,1,2100000
3012,Ikorodu,ikorodu lagos,8,6,3,3,3,1,1,1,1,1,5250000
3013,Ikorodu," behind cluster bar, off ebute igbogbo road, ebute ikorodu lagos",8,2,1,1,1,1,1,1,1,1,2310000
3014,Ikorodu,ikorodu lagos,8,4,2,2,2,0,0,0,0,1,2100000
3015,Ikorodu,ikorodu road shomolu lagos,8,7,4,3,4,1,1,1,1,3,12600000
3016,Ikorodu,unity first gate(cole house) igbogbo ikorodu lagos,8,2,1,1,1,0,0,0,0,1,882000
3017,Ikorodu," renecon road,macaulay str igbogbo ikorodu lagos",8,2,1,1,1,0,0,0,0,1,1050000
3018,Ikorodu,sikiru jimoh str igbogbo ikorodu lagos,8,2,1,1,1,1,1,0,1,1,1575000
3019,Ikorodu,chris kpakpovwe street igbogbo ikorodu lagos,8,5,3,2,3,0,0,0,0,1,2100000
3020,Ikorodu," iya folake str,macaulay igbogbo ikorodu lagos",8,3,2,1,2,0,0,0,0,1,1260000
3021,Ikorodu,igbe laara ikorodu ikorodu lagos,8,2,1,1,1,0,0,0,0,1,840000
3022,Ikorodu,emily avenue igbogbo ikorodu lagos,8,2,1,1,1,0,0,0,0,1,840000
3023,Ikorodu,orjih bus stop igbogbo ikorodu lagos,8,2,1,1,1,0,0,0,0,1,1050000
3024,Ikorodu,ikorodu lagos,8,4,2,2,2,1,1,1,1,1,4725000
3025,Ikorodu,emily avenue igbogbo ikorodu lagos,8,4,2,2,2,0,0,0,1,1,2625000
3026,Ikorodu,unity b/s bayeku road igbogbo ikorodu lagos,8,2,1,1,1,0,0,0,0,1,840000
3027,Ikorodu,ikorodu lagos,8,6,3,3,3,1,0,0,1,1,4200000
3028,Ikorodu,fawole street igbogbo ikorodu lagos,8,5,3,2,3,0,0,0,0,1,2100000
3029,Ikorodu,selewu street igbogbo ikorodu lagos,8,2,1,1,1,0,0,0,0,1,882000
3030,Ikorodu,teachers quarter selewu igbogbo igbogbo ikorodu lagos,8,2,1,1,1,0,0,0,1,1,1260000
3031,Ikorodu," owode-ibeshe, off ebute-ibeshe road ebute ikorodu lagos",8,3,2,1,2,1,1,1,1,1,4200000
3032,Ikorodu,ikorodu road shomolu lagos,8,7,4,3,4,1,1,1,1,3,12600000
3033,Ikorodu,macaulay igbogbo ikorodu lagos,8,5,3,2,3,0,0,0,0,1,2100000
3034,Ikorodu,macaulay igbogbo ikorodu lagos,8,2,1,1,1,0,0,0,1,1,1470000
3035,Ikorodu,ikorodu lagos,8,2,1,1,1,0,0,0,0,1,1050000
3036,Ikorodu,emily avenue igbogbo ikorodu lagos,8,5,3,2,3,0,0,0,0,1,2625000
3037,Ikorodu,ekundayo street igbogbo ikorodu lagos,8,4,2,2,2,0,0,0,1,1,2625000
3038,Ikorodu,ikorodu lagos,8,4,2,2,2,1,1,1,1,1,4725000
3039,Ikorodu,teacher's quarter igbogbo ikorodu lagos,8,2,1,1,1,0,0,0,1,1,1260000
3040,Ikorodu,macaulay inside igbogbo ikorodu lagos,8,2,1,1,1,0,0,0,1,1,1260000
3041,Ikorodu,fawole bus stop igbogbo ikorodu lagos,8,2,1,1,1,0,0,0,0,1,840000
3042,Ikorodu,elepe royal estate ebute ikorodu lagos,8,5,3,2,3,1,1,1,1,1,9450000
3043,Ikorodu,ajakaye street igbogbo ikorodu lagos,8,5,3,2,3,0,0,0,0,1,2100000
3044,Ikorodu,ogunlewe street igbogbo ikorodu lagos,8,2,1,1,1,1,1,0,1,1,1575000
3045,Ikorodu,ikorodu lagos,8,6,3,3,3,0,0,0,1,1,3675000
3046,Ikorodu," total light school,grammar school area ikorodu lagos",8,7,4,3,4,0,0,0,0,3,4200000
3047,Ikorodu,macaulay str igbogbo ikorodu lagos,8,2,1,1,1,0,0,0,0,1,840000
3048,Ikorodu,ekundayo street igbogbo ikorodu lagos,8,2,1,1,1,0,0,0,0,1,840000
3049,Ikorodu,ikorodu lagos,8,4,2,2,2,1,1,1,1,1,6300000
3050,Ikorodu,ikorodu lagos,8,2,1,1,1,1,1,1,1,1,2100000
3051,Ikorodu,lfi igbogbo ikorodu lagos,8,3,2,1,2,0,0,0,0,1,1575000
3052,Ikorodu,selewu street igbogbo ikorodu lagos,8,2,1,1,1,0,0,0,0,1,882000
3053,Ikorodu,teachers quarter selewu igbogbo igbogbo ikorodu lagos,8,2,1,1,1,0,0,0,1,1,1260000
3054,Ikorodu,ikorodu lagos,8,4,2,2,2,0,0,0,1,1,2625000
3055,Ikorodu,ikorodu lagos,8,2,1,1,1,1,1,0,1,1,1575000
3056,Ikorodu,maternity right side igbogbo ikorodu lagos,8,3,2,1,2,0,0,0,0,1,1365000
3057,Ikorodu,maternity street igbogbo ikorodu lagos,8,5,3,2,3,0,0,0,0,1,2100000
3058,Ikorodu," korperate,macaulay igbogbo ikorodu lagos",8,2,1,1,1,0,0,0,0,1,840000
3059,Ikorodu,ikorodu express rd ojota ojota ojota lagos,8,12,6,6,6,1,1,0,1,6,15750000
3060,Ikorodu," offin, igbogbo igbogbo ikorodu lagos",8,4,2,2,2,0,0,0,0,1,2100000
3061,Ikorodu,harmony ebute ikorodu lagos,8,8,4,4,4,0,0,0,0,3,4200000
3062,Ikorodu,oga- oloye street igbogbo ikorodu lagos,8,4,2,2,2,0,0,0,0,1,1575000
3063,Ikorodu,"olarenwaju avenue, igbe laara, ikorodu. 08080763982 ikorodu ikorodu lagos",8,4,2,2,2,0,0,0,0,1,1575000
3064,Ikorodu," eleshin area, itamaga, ikorodu lagos",8,6,3,3,3,0,0,0,0,1,3150000
3065,Ikorodu,agunfoye beside lagos state model college igbogbo ikorodu lagos,8,7,4,3,4,0,0,0,0,3,4200000
3066,Ikorodu," patrick uzor street, agura ikorodu ikorodu ikorodu lagos",8,5,3,2,3,0,0,0,0,1,2100000
3067,Ikorodu," hilltop estate radio,itamaga ikorodu ikorodu lagos",8,2,1,1,1,1,1,0,1,1,1575000
3068,Ikorodu,"3, lead way drive igbolomu agric agric ikorodu lagos",8,4,2,2,2,0,0,0,0,1,1575000
3069,Ikorodu,1 keyolu street erunwen ikorodu lagos ikorodu ikorodu lagos,8,2,1,1,1,1,1,0,1,1,1575000
3070,Ikorodu,ebute road ikorodu lagos,8,4,2,2,2,0,0,0,1,1,3150000
3071,Ikorodu,ebute road ebute ikorodu lagos,8,6,3,3,3,1,1,1,1,1,6300000
3072,Ikorodu,alago off radio ikorodu ikorodu lagos,8,2,1,1,1,0,0,0,1,1,1260000
3073,Ikorodu,"2, oladogba street, opposite federal low cost housing estate. akasoleri. ikorodu -old ijebu ode road, after ile episode bus stop. ikorodu ikorodu lagos",8,3,2,1,2,0,0,0,0,1,1890000
3074,Ikorodu," nurudeen oyebola street,yusuf bus stop, selewu igbogbo ikorodu lagos",8,6,3,3,3,0,0,0,0,1,2100000
3075,Surulere,masha surulere lagos,9,5,3,2,3,1,1,1,1,5,17850000
3076,Surulere,off adeniran ogunsanya adeniran ogunsanya surulere lagos,9,6,3,3,3,1,1,0,1,5,15750000
3077,Surulere,raufu williams off adisa bashua street adelabu surulere lagos,9,8,4,4,4,1,1,1,1,6,31500000
3078,Surulere,johnson street bode thomas surulere lagos,9,5,3,2,3,1,1,0,1,5,15750000
3079,Surulere,bethel estate iponri iponri surulere lagos,9,9,5,4,5,0,0,0,0,8,31500000
3080,Surulere,seriki street idi araba surulere lagos,9,5,3,2,3,0,0,0,0,5,7350000
3081,Surulere,benson street off akerele street ogunlana surulere lagos,9,6,3,3,3,1,1,0,1,5,15750000
3082,Surulere,off cole street by olufemi street via ogunlana surulere lagos,9,7,4,3,4,0,0,0,0,6,10500000
3083,Surulere,anjorin street off cole street via olufemi street ogunlana surulere lagos,9,6,3,3,3,1,1,0,1,5,15750000
3084,Surulere,a serene environment off oyekan street ogunlana surulere lagos,9,9,5,4,5,1,1,0,1,8,36750000
3085,Surulere,games village bode thomas surulere lagos,9,2,1,1,1,1,1,1,1,2,7350000
3086,Surulere,rasaq balogun street adeniran ogunsanya surulere lagos,9,4,2,2,2,1,1,1,1,4,15750000
3087,Surulere,"  eric manuel crescent, off bode thomas street, surulere lagos bode thomas surulere lagos",9,8,4,4,4,1,0,1,1,6,26250000
3088,Surulere,obele surulere lagos,9,2,1,1,1,0,0,0,1,2,5250000
3089,Surulere,kilo marsha surulere lagos,9,8,4,4,4,1,1,1,1,6,31500000
3090,Surulere,lawanson surulere lagos,9,5,3,2,3,0,0,0,0,5,9975000
3091,Surulere,lawanson surulere lagos,9,7,4,3,4,0,0,0,1,6,13650000
3092,Surulere,off cole street. lawanson surulere lagos,9,5,3,2,3,0,0,0,0,5,9975000
3093,Surulere,akinhanmi western avenue surulere lagos,9,2,1,1,1,1,1,1,1,2,7350000
3094,Surulere,bashiru agusto street bode thomas surulere lagos,9,4,2,2,2,1,0,1,1,4,13650000
3095,Surulere,bamk olemoh ogunlana surulere lagos,9,4,2,2,2,0,0,0,0,4,7350000
3096,Surulere,simisola street ogunlana surulere lagos,9,2,1,1,1,1,1,1,1,2,7350000
3097,Surulere,ketu close aguda surulere lagos,9,5,3,2,3,0,0,0,0,5,7875000
3098,Surulere,- bode thomas surulere lagos,9,9,5,4,5,0,0,0,0,8,26250000
3099,Surulere,back of luth idi araba surulere lagos,9,2,1,1,1,0,0,0,0,2,3675000
3100,Surulere,adekunle kuye street adelabu surulere lagos,9,5,3,2,3,0,0,0,1,5,10500000
3101,Surulere,masha surulere lagos,9,6,3,3,3,0,0,0,1,5,13125000
3102,Surulere,jalupon adeniran ogunsanya surulere lagos,9,9,5,4,5,0,0,0,1,8,33600000
3103,Surulere,folawiyo bankole street masha surulere lagos,9,7,4,3,4,0,0,0,1,6,15750000
3104,Surulere,off eloseh street adelabu surulere lagos,9,7,4,3,4,0,0,0,1,6,21000000
3105,Surulere,ladipo labinjo bode thomas surulere lagos,9,12,6,6,6,1,1,0,1,8,31500000
3106,Surulere,olayemi street off nnobi street by agboyin street adelabu surulere lagos,9,6,3,3,3,1,1,0,1,5,15750000
3107,Surulere,cole street lawanson surulere lagos,9,6,3,3,3,0,0,0,0,5,7350000
3108,Surulere,kilo marsha surulere lagos,9,6,3,3,3,0,0,0,1,5,12600000
3109,Surulere,adeniran ogunsanya surulere lagos,9,6,3,3,3,1,1,1,1,5,21000000
3110,Surulere,... adeniran ogunsanya surulere lagos,9,4,2,2,2,1,1,1,1,4,15750000
3111,Surulere,- western avenue surulere lagos,9,2,1,1,1,0,0,0,0,2,3150000
3112,Surulere,- masha surulere lagos,9,4,2,2,2,0,0,0,1,4,8925000
3113,Surulere,ogunlana surulere lagos,9,7,4,3,4,0,0,0,1,6,13650000
3114,Surulere,off lawonson road lawanson surulere lagos,9,6,3,3,3,0,0,0,0,5,7350000
3115,Surulere,.. ogunlana surulere lagos,9,4,2,2,2,0,0,0,1,4,10500000
3116,Surulere,obele ogunlana surulere lagos,9,4,2,2,2,0,0,0,0,4,8400000
3117,Surulere,ogunlana surulere lagos,9,2,1,1,1,0,0,0,0,2,3675000
3118,Surulere,western avenue surulere lagos,9,2,1,1,1,0,0,0,0,2,4200000
3119,Surulere,- western avenue surulere lagos,9,13,5,8,5,1,1,0,1,8,36750000
3120,Surulere,.. adelabu surulere lagos,9,4,2,2,2,0,0,0,1,4,10500000
3121,Surulere,ogunlana surulere lagos,9,2,1,1,1,0,0,0,1,2,5250000
3122,Surulere,ogunlana surulere lagos,9,6,3,3,3,0,0,0,1,5,10500000
3123,Surulere,off ojuelegba road ojuelegba surulere lagos,9,2,1,1,1,0,0,0,0,2,4200000
3124,Surulere,adelabu surulere lagos,9,2,1,1,1,1,1,1,1,2,7350000
3125,Surulere,close to ojuelegba ojuelegba surulere lagos,9,2,1,1,1,0,0,0,1,2,5250000
3126,Surulere,off lawonson lawanson surulere lagos,9,2,1,1,1,0,0,0,0,2,4200000
3127,Surulere,kilo marsha surulere lagos,9,6,3,3,3,1,1,1,1,5,21000000
3128,Surulere,ogunlana surulere lagos,9,2,1,1,1,1,1,1,1,2,7350000
3129,Surulere,akerele randle avenue surulere lagos,9,4,2,2,2,0,0,0,0,4,5250000
3130,Surulere,airways ijesha surulere lagos,9,2,1,1,1,0,0,0,0,2,3675000
3131,Surulere,airways ijesha surulere lagos,9,2,1,1,1,0,0,0,0,2,3675000
3132,Surulere," akinyele streeta off adekunle kuye,by adelabu surulere aguda surulere lagos",9,6,3,3,3,0,0,0,0,5,8400000
3133,Surulere,airways ijesha surulere lagos,9,2,1,1,1,0,0,0,0,2,3675000
3134,Surulere,off ogunlana drive ogunlana surulere lagos,9,6,3,3,3,1,1,0,1,5,16800000
3135,Surulere,ishaga road itire surulere lagos,9,6,3,3,3,0,0,0,0,5,7875000
3136,Surulere,ishaga road itire surulere lagos,9,4,2,2,2,0,0,0,0,4,7350000
3137,Surulere," by akanbi crescent off aturashe , surulere lagos ojuelegba surulere lagos",9,7,4,3,4,0,0,0,0,6,10500000
3138,Surulere,off cole street lawanson surulere lagos,9,6,3,3,3,0,0,0,0,5,9975000
3139,Surulere," ishaga road, via luth ojuelegba surulere lagos",9,2,1,1,1,0,0,0,0,2,3150000
3140,Surulere,idita bode thomas surulere lagos,9,2,1,1,1,1,1,1,1,2,7350000
3141,Surulere,off bode thomas bode thomas surulere lagos,9,2,1,1,1,1,1,1,1,2,7350000
3142,Surulere,karowi off oduduwa kilo kilo marsha surulere lagos,9,4,2,2,2,0,0,0,0,4,5250000
3143,Surulere,off ishaga road idi araba surulere lagos,9,6,3,3,3,0,0,0,0,5,7350000
3144,Surulere,lawanson surulere lawanson surulere lagos,9,7,4,3,4,0,0,0,1,6,13650000
3145,Surulere,off cole street lawanson surulere lagos,9,6,3,3,3,0,0,0,0,5,9975000
3146,Surulere," off lawanson road, by zenith bank lawanson surulere lagos",9,4,2,2,2,0,0,0,0,4,5250000
3147,Surulere," by akanbi crescent off aturashe , surulere lagos ojuelegba surulere lagos",9,6,3,3,3,1,1,0,1,5,15750000
3148,Surulere,adeniran ogunsanya adeniran ogunsanya surulere lagos,9,16,8,8,8,1,1,0,1,9,42000000
3149,Surulere,sam-shonibare estate by olufemi off ogunlauna drive ogunlana surulere lagos,9,6,3,3,3,0,0,0,1,5,10500000
3150,Surulere,- lawanson surulere lagos,9,7,4,3,4,0,0,0,0,6,10500000
3151,Surulere,lawanson surulere lagos,9,6,3,3,3,0,0,0,0,5,7350000
3152,Surulere,off ishaga rd via (luth) surulere ojuelegba surulere lagos,9,4,2,2,2,1,1,1,1,4,15750000
3153,Surulere,michael ogun street by ogunlauna junction by itere ogunlana surulere lagos,9,2,1,1,1,0,0,0,1,2,5250000
3154,Surulere,off masha masha surulere lagos,9,2,1,1,1,0,0,0,1,2,6300000
3155,Surulere,"119 ogunlana drive surulere, lagos ogunlana surulere lagos",9,5,3,2,3,0,0,0,1,5,10500000
3156,Surulere,off aguda aguda surulere lagos,9,6,3,3,3,0,0,0,1,5,10500000
3157,Surulere,anjorin street lawanson lawanson surulere lagos,9,6,3,3,3,0,0,0,1,5,13650000
3158,Surulere,obele street lawanson surulere lagos,9,2,1,1,1,0,0,0,1,2,5250000
3159,Surulere,off ogunsanya bode thomas surulere lagos,9,7,4,3,4,1,1,1,1,6,29400000
3160,Surulere,off ogunsanya bode thomas surulere lagos,9,5,3,2,3,1,1,1,1,5,21000000
3161,Surulere,iseyin off adeshina ijesha surulere lagos,9,8,4,4,4,0,0,0,0,6,10500000
3162,Surulere,ibudun western avenue surulere lagos,9,2,1,1,1,0,0,0,0,2,4725000
3163,Surulere,olufemi ogunlana surulere lagos,9,5,3,2,3,0,0,0,1,5,13650000